абдурахим: абдурахим
даугавпилс: даугавпилсе даугавпилса
соучредительница: соучредительница соучредительницей
автоматизация: автоматизация
поиск: поисках поиском поиску поиска
махачкала: махачкала
литий: лития
держать: держал держит
покинуть: покинул покинуть покинула
лицо: лицами лицах
могильник: могильнике могильников могильника
болезнь: болезней болезням болезнью болезнях
филиал: филиалом филиала
контакт: контактах контактов
признак: признак признаков
пьеса: пьес
исключительный: исключительное исключительную
регион: регионах региона региону регионе регионов регионами
больной: болен больных
анна: анны анна анной анну
пригласить: приглашена приглашен пригласил
московский: московскую московская
луч: лучей луча
включать: включали включал включает включают включало
пользоваться: пользовались пользоваться пользовался пользуясь пользовалась
ходить: ходил
прохоров: прохоров
дрезден: дрездена
демков: демков
истребить: истреблены
гипотеза: гипотезу гипотеза гипотез
служить: служить служа служил
антиферромагнетизм: антиферромагнетизма
составить: составила составлен составить составили составлены составлена составил
цыганов: цыганов
гораздо: гораздо
нумизматика: нумизматика нумизматикой
закон: законов законом закона законам
наименование: наименований
перевести: переведено переведена перевели переведены перевести
изложение: изложения изложением изложении
острый: острыми острая
полагать: полагали полагая полагает
остаться: останется оставшаяся остался остаться оставшимися осталось осталась
арциз: арцизе
металлический: металлическую
меморандум: меморандума
ноосфера: ноосфера
жырауск: жырауском
экспортный: экспортно
алгебра: алгебра алгебру
садоводство: садоводстве садоводству
следовать: следуют следует
министерство: министерство министерству министерств министерстве министерством министерства
ростов: ростове
произведение: произведений
витебский: витебская
частный: частный частную частная частными
узбекистан: узбекистана
недра: недр
васильев: васильев
миеломатоз: миеломатоза
дисциплина: дисциплины дисциплину
касим: касим касимом
быть: будучи будут
ержанович: ержанович
сборник: сборников сборника сборнике сборниках сборнику
определение: определении определения определением определение определению
преступление: преступлениями
параболоид: параболоида
грамота: грамотой грамота грамотами
совет: советов совете совета совету
рассмотрение: рассмотрении рассмотрению
оргкомитет: оргкомитета
расширять: расширяет
вц: вц
фронт: фронта фронтах фронте
макроэкономика: макроэкономики макроэкономика
себя: собой собою
правительство: правительства правительстве правительством правительство
выступать: выступает выступал выступала
даниэль: даниэль
эксперимент: эксперименте эксперимента экспериментов
алма: алма
дифференциальный: дифференциальных дифференциальными
иван: иване иван
готлиб: готлиб
карта: карт карта картами
увидеть: увидела увидел увидеть
дать: дал дать дало дала дана
патологоанатом: патологоанатом патологоанатомы
человек: людях человеком люди людям людьми
керченский: керченская
кажегельдин: кажегельдин
болга: болг
уильям: уильям уильяма
публиковаться: публиковалась публиковался публиковались
который: которая который которую которыми
карен: карен карену
тот: тому та тех ту
давление: давлением давлений давлениях давления давлении
разделиться: разделился
абен: абен
улучшение: улучшению улучшении улучшения
савин: савин
прозектор: прозектором прозектор
родина: родину
обладать: обладающими обладал
месторождение: месторождений
фармакологически: фармакологически
войцеховский: войцеховский
военный: военная военную военно
овцеводство: овцеводстве овцеводству
состояться: состоялась состоявшаяся состоялись состоялось
информационный: информационная информационных
май: мае мая
офицер: офицером офицера офицеры офицер
нигде: нигде
миф: мифы мифа
проведение: проведению проведения проведении
моисей: моисеем моисей
андерсон: андерсона
аппендицит: аппендицита
мухаммад: мухаммадом мухаммад
приложение: приложений
клайв: клайв
хэдингтон: хэдингтоне
постановление: постановлением постановлению постановление
ездить: ездил
гми: гми
вычислить: вычислит
река: реку реки река реками рек
публиковать: публикует публиковал
размик: размик
отметить: отмечена отметить отметили отмечен отметила отметил
лилиенталь: лилиенталю лилиенталем
сократить: сокращено сократил
некий: некая некоем
прочее: прочего
выделение: выделении выделения
викификация: викификацией
клосса: клосс
конкордат: конкордата
осудить: осудили
пособие: пособий пособием пособие
монах: монахом
детство: детства детстве
брат: братьев братом брат братья братьям
хадис: хадисы
всесоюзный: всесоюзная
судебный: судебных
решить: решив решили решила решить решено решил
макдональд: макдональд
повторять: повторяя
кормовой: кормовая
курс: курсов курсах курсом курсе курса курсу
серия: серию серия
считаться: считаться считаются считался считается
сэр: сэр сэра
регулярно: регулярно
сохраниться: сохранились сохранилось сохранившуюся сохранившаяся сохранилась сохранился
эйнштейн: эйнштейна
соседствовать: соседствовала
вызвать: вызвало вызвал
любопытный: любопытную
лондон: лондона лондоне
пловец: пловцом
берег: берегов берегу
православный: православной православная
тюльпан: тюльпанов
продолжатель: продолжателям продолжателем
справа: справа справ
гаффар: гаффар
цикл: цикла циклами цикле циклов
посещать: посещали посещал посещая посещать
натанович: натанович
разработка: разработка разработку разработки разработок разработкой
вкл: вкл
древний: древнем древнюю древнейших древняя
успех: успехов успеха
зима: зима
геометрия: геометрия геометрию
поселение: поселений поселениям поселении
курганский: курганская
прожить: прожила прожить прожили прожил
классификация: классификацию классификация
илл: илл
расшифровка: расшифровка
пояс: поясов поясам
константинополь: константинополя константинополем константинополю
дружба: дружбы дружба
дед: дед
ионный: ионными ионно
лаборант: лаборантом лаборант
докторантура: докторантура докторантуру
тюрколог: тюркологи тюрколог
аболтиньша: аболтиньша
викицитатник: викицитатник викицитатнике
уссурийск: уссурийске
венеция: венецией венеция
сула: сула
листок: листка
январь: январе января
распоряжение: распоряжении
солдат: солдатом солдатами
радиационный: радиационная
освободительный: освободительная освободительную
степанович: степанович степановну степановна
сага: сагу
процесс: процесса процессам процессов процессом процессе процессу
обозначить: обозначены
столлман: столлман
участие: участием участия участии участие
акопович: акопович
современный: современная современную современными современного
повод: повода поводу поводом
соответствие: соответствии соответствием
юстиция: юстиции
учить: учил
пополнять: пополняя пополнять
краснов: краснов
ить: лено
методика: методику методика методикам
уходить: уходит
образовательный: образовательными образовательная
полномочие: полномочий
полевой: полевые полевых полевую
утилизировать: утилизируя
максимович: максимович
вначале: вначале
поле: полями полях
оттуда: оттуда
новелла: новеллах новелл
нарушение: нарушением нарушениями нарушений
белый: белую белыми
позволить: позволила позволил позволить позволившую позволили позволило
дмитриевич: дмитриевич дмитриевна
предок: предками предка
разработчик: разработчиков разработчик разработчики
обстановка: обстановки
наследие: наследия наследии
теоретический: теоретическую теоретическая
преподавание: преподаванием преподавании преподавания
филолог: филологом филолог филологи филологах
преодолевать: преодолевая
вырастить: вырастили
эпоха: эпоха эпох эпоху эпохи
таннай: таннаи
направляться: направлялись направлялся направляется
происходить: происходил происходят происходит
голова: голова
население: население населением населения
омрачить: омрачено
путеводитель: путеводитель
запад: западе западу запада
дефицит: дефицита
обеспечение: обеспечении обеспечению обеспечения
море: морей моря
неэнциклопедичный: неэнциклопедичен
андреевич: андреевич андреевна
честь: честь
предшественник: предшественник предшественники
война: война войне войну войнами войнах войн войны
центр: центрами центре центра центром центрах центров
гордиться: гордимся горжусь
спектр: спектре спектрам спектра
принцип: принципе принципа принципах принципу принципами
конец: конца конце концах концу
унаследовать: унаследовал
аш: аш
виталий: виталием
переезжать: переезжает
бэ: бэ
арктика: арктики
простой: просты простая простую
правда: правду правды
строительный: строительная строительных
том: томах
кинематографист: кинематографистов
перевод: переводами переводов переводах переводе переводу перевода переводом
екатерина: екатерины
лежать: лежали лежат
диабет: диабетом
время: времена временем время
геолог: геолог геологи геологу геологом
устранить: устранены
каэ: каэ
бакалавр: бакалавр бакалавра бакалавры
германия: германия германию германией
тяжело: тяжело
повлиять: повлияла повлиял
исследование: исследований исследованию исследованиями исследованиям исследованиях исследованием исследовании
узел: узлах узлов узла узлом
янг: янг
изготовление: изготовлении изготовления
посвятить: посвященная посвящены посвятить посвящена посвятил посвящено
гунтис: гунтисом
ветеринар: ветеринар ветеринары
архив: архив архиве архива архивов
ходовой: ходовую
польза: пользу
уход: ухода уходу уходе уходом
хороший: лучшую хороший лучшем лучшая хорошему
помощь: помощью
сводка: сводка
редакция: редакция редакцией редакциях
комета: комет
существовать: существует существовавшую существовало существовал существуют
конференция: конференцию конференция конференциях конференций
линия: линиям линиях линий
практика: практика практику практике практики практикой
литература: литературы литературе литература литературу литературой
союз: союза союзе союзом
глагол: глаголов глагола
свобода: свободы
источниковед: источниковед
патент: патентов патента
карбонильный: карбонильными
айболит: айболит
советский: советское советскую советская
репарация: репарациям
зах: зах
египтолог: египтологом
коммунист: коммунист
тадж: тадж
радиофон: радиофоне
микровид: микровидов
коммерческий: коммерческая
площадь: площадью
измерение: измерений измерениями измерении
окт: окт
обескремнивание: обескремнивания
немецкий: немецкие немецком немецкая
годовщина: годовщине
переход: переходах переходам переходе переходов переходами перехода
ггу: ггу
граница: границей граница границу
хусейн: хусейн
выдвинуть: выдвинул выдвинуты выдвинуто
сидеть: сидел сидит сидели
похоронить: похоронена
абрахам: абрахамом абрахаму абрахам
проектный: проектно
удалить: удалена удалены удалить
зык: зыков
состоять: состоит состояла состоя состоял
справка: справках справка
гауя: гауи
мартирос: мартирос
стрелковый: стрелковая
общаться: общался общаюсь общались общаясь
превратиться: превратилась
патерик: патерике
советник: советник советником советники советника
срок: сроком
присоединиться: присоединился присоединилась
калькутта: калькутта
торквемада: торквемадой
сфера: сферу сферой сфере сферами сфера
собрание: собраний собрания собранием собраниях собрании
ускорение: ускорения ускорению
фёдорович: федорович
разрешить: разрешило разрешили разрешил
нагрузка: нагрузками нагрузок нагрузка
выбрать: выбрало выбрана выбрала выбрал
надзор: надзору
половина: половины половине половина
академия: академию академия академий академией
называться: называлась называется назывался называться называются
луцк: луцке
природа: природы природой природе природа
кузьмин: кузьмин
электрон: электронами электрона электронов
ученик: ученике учеником учениками ученик ученики
путеец: путеец
бенджамин: бенджамин
поддерживать: поддерживать поддерживал поддерживали
ростиславович: ростиславович
уро: уро
новочеркасск: новочеркасске
пастор: пасторы пастор пастором
командир: командир командиром командиры
виктор: виктор виктора
охотовед: охотоведы охотовед
мад: мад
апитерапия: апитерапия
музыкант: музыкант
продолжаться: продолжалось продолжался
терпен: терпенов
педагог: педагоги педагог педагогов
главный: главный главная главных главными
газ: газов газах газа
политологический: политологическими
метасистема: метасистем
начать: начал начать начав
возглавлять: возглавляет возглавляемая возглавлял возглавляла
изтелеу: изтелеуов
английский: английские английская английском английским
учительница: учительница
восстановление: восстановлению восстановления восстановлении
беженец: беженцам беженцев беженцы
заканчивать: заканчивая заканчивает заканчивал
освоение: освоения освоением
выполнить: выполнили выполненная выполнил выполнены выполнить
мягкий: мягка
владелец: владельца владельцы владельцев владельцем
отмывание: отмыванием
физический: физическая физических физического
философ: философа философе философы философ
кадровый: кадровая
обвинение: обвинению
камень: камней
бахчисарай: бахчисарае
акушер: акушером акушер
страна: стране страны страна странах стран странам
иванович: ивановна иванович
убайд: убайда
потребление: потребления
вступление: вступлении
стать: стать стало стали стала станет стал став ставшая
аля: аля
отставка: отставку отставке
дж: дж джам
восходить: восходит
обнаружение: обнаружению обнаружении обнаружения
восьмилетний: восьмилетняя
возвращение: возвращения возвращении
барьер: барьера барьерами
ресторан: ресторана
филология: филологию филология
фабрика: фабрика фабрикой
партком: парткома
руководство: руководством руководств руководства руководстве
тянуть: тянет
хранитель: хранителем хранители
исфахан: исфахана
недропользование: недропользованию
кодекс: кодекса кодексу
сепаратор: сепаратора
шедевр: шедевров
университет: университетом университете университета университетов университету университетах
направить: направлен направленными направлена
сознание: сознания
сержант: сержант сержанты
министр: министром министров министр министру министры
связь: связям связях связей
факультет: факультета факультетах факультетов факультете
бетесд: бетесда бетесде
повысить: повысить повысили
производство: производств производстве производством производства
гаврилович: гаврилович
ен: ен
пункт: пунктов пункта
славянин: славянах славяне
яуза: яуза
распутие: распутьи
мэв: мэв
ключевой: ключевыми ключевую
преследование: преследованиям преследованию
сложение: сложении
андрей: андрею андрей
обучение: обучению обучения
менделеев: менделеев
теоретик: теоретики теоретик
церковный: церковно
комментатор: комментатор комментаторы комментатором комментаторах
томкинс: томкинс
иремельский: иремельскую
палеонтолог: палеонтолог палеонтологом палеонтологи
украина: украины украина
российский: российскому российский российская российские российской
критерий: критериев критериям критериях критерию
принести: принесли принесло
активность: активностью
халифат: халифата халифате
лермонтов: лермонтове
снятие: снятия
армия: армию армией армия
вступать: вступает вступаю
отечество: отечеством отечества
взаимодействие: взаимодействия взаимодействию взаимодействии
продолжить: продолжил продолжила продолжить продолжившую продолжив продолжили
охлаждение: охлаждение охлаждения
южноитальянский: южноитальянская
медиевист: медиевисты медиевист
сравнить: сравнить
разработать: разработали разработал разработать разработаны разработала разработана разработан
антология: антологию антология
анм: анм
иаа: иаа
страхование: страховании страхования
евразия: евразия
государство: государствах государств государства государству государство
металлургический: металлургическая металлургическими
соймонов: соймонове
преемник: преемник преемником
течение: течение течений течении
горнорудный: горнорудная
брак: браке брака
содержание: содержанием содержании содержания
абелла: абелла абеллой
абрамовица: абрамовица абрамовиц
заканчиваться: заканчиваются заканчивается
машиностроитель: машиностроители
получить: получен получено получили получила получит полученных получив получить получил получившую
абовян: абовяна абовяну
латиница: латинице
отличник: отличник отличники
батька: батька
дело: делах делом деле дел делам делу делами
индеец: индейцы индейцами
метеоролог: метеорологи метеоролог метеорологом
хотеть: хочу хотела хотел
расширить: расширив расширил расширить
четыре: четырьмя четыре
пед: пед
багдад: багдаде багдада
кузнец: кузнец
сорт: сортов
правило: правил правило правилам правилом
ток: токами токов
финляндия: финляндию финляндия финляндией
пан: пан
определять: определяли определяющую
консультант: консультант консультанты консультантом
подавление: подавления
переславль: переславля переславле
ознакомление: ознакомления
сын: сын сыном сыне сыну
нацыянальный: нацыянальны
ядерщик: ядерщики
лекция: лекцией лекций лекциями лекция
рих: рих
национальный: национальными национальных национального национальная
ассистент: ассистентом ассистент
остин: остин остине
эксперт: экспертом экспертов эксперт эксперта
сахалин: сахалину сахалина сахалине сахалин
реконструкция: реконструкция
разрабатываться: разрабатываются
встреча: встрече встречах встреча
неактивный: неактивна
множество: множества множестве
болото: болот
морской: морскими морскую морских
докторант: докторант
шатой: шатое
магнитный: магнитные магнитными магнитного магнитно магнитных
горный: горно горными
джонатан: джонатан
спецпроцессор: спецпроцессоров
электризация: электризация
зоотехния: зоотехния
архитектура: архитектур архитектуры архитектуре архитектурой архитектурах
сибирский: сибирская сибирскую
хронист: хронисты
отсутствие: отсутствия
сооружение: сооружениях сооружений
викторович: викторовна викторович
достояние: достоянии
характеризовать: характеризуя
отделение: отделений отделением отделению отделения отделении
подразделение: подразделениях подразделением подразделении
узб: узб
донбасс: донбасса
специальный: специального специальную специальному специальная
телевидение: телевидения телевидении
середина: середине середину середины
результат: результатом результату результате результатам результатов результатах
достигнуть: достиг достичь
жвмимфа: жвмимф
опубликовать: опубликованную опубликованная опубликовать опубликован опубликовано опубликовал опубликована опубликованы опубликовала
лозинский: лозинский
либреттист: либреттисты либреттист
проблема: проблема проблемами проблемам проблем проблемой проблему
генрих: генриха генрих
переработка: переработке переработка переработки
химия: химий химией химию химия
неоламаркизм: неоламаркизма
подбивать: подбивал
остров: острове островах островов
проживание: проживания
социалистический: социалистическая
самостоятельный: самостоятельную
назначить: назначена назначили назначил назначен
биоседой: биосед
организм: организма организмов
эпилепсия: эпилепсией
куйбышевский: куйбышевском
гуггенхайм: гуггенхайма
мухаммед: мухаммедом мухаммед
субклеточный: субклеточная
международный: международно международная международную международном международный
герат: герате
азербайджанский: азербайджанская
дереник: дереник
закарий: закари
дилемма: дилемм дилемма
труд: трудом трудов трудах труда труде
преуспеть: преуспел
реализация: реализацию реализация реализацией
олегович: олеговна
метаанализ: метаанализа
башкортостан: башкортостане башкортостана башкортостан
культура: культурах культур культуру культура культуры культурам
коммунистический: коммунистическая
древесный: древесная
северный: севернее северная северному
нто: нто
наркомзем: наркомзема
обусловливать: обусловливали
внук: внуком внуки внук
подойти: подойдет
материал: материалам материалах материале материалов материала материалом
сардарбек: сардарбек
фамилия: фамилию фамилия фамилией фамилиями
декан: декан деканы деканом
дата: дата дату даты дат
случай: случаях случаи случаю случая случаев случае
эндемизм: эндемизма
конверт: конверте конверта конвертов
обнаружить: обнаружили обнаружен обнаружив обнаружил обнаружены обнаружить обнаружила обнаружено
число: числе чисел числах числа числу числом
рука: рук руках руку
обозреть: обозреть
стенограмма: стенограмма
бедный: бедна
начальник: начальником начальник начальников
выдать: выдана выдал выдать
вильнюс: вильнюсом вильнюсе
предполагать: предполагал предполагать предполагают
юде: юде
мирянин: мирянин
ренессансовед: ренессансоведы
наполнитель: наполнителя
описываться: описываются
апн: апн
ра: ра
втрое: втрое
макей: макей
рассматриваться: рассматривается рассматривался рассматривалась
заниматься: заниматься занималось занимались занимается занимался занималась
текст: текстов тексте текста текстом тексту
название: названиями названий названиях названием
уделить: уделил
гэй: гэй
обвиняться: обвиняется
сила: сил силах силой
исправление: исправлении
проворн: проворнов
оживить: оживив
хои: хои
вообще: вообще
благ: благов
свидетель: свидетелем
заменить: заменить заменили заменил
патология: патологий патология
делаться: делается
приступ: приступа приступ
лауреат: лауреат лауреатом лауреату лауреаты
секрет: секрета
идея: идея идей идеями идеям
монография: монографией монография монографий монографию
вгик: вгике вгика
гранд: гранд
ткань: тканей тканями
избираться: избирался
заведовать: заведуя заведующая заведовал
критик: критиком критик
развеять: развеян
хорватия: хорватия
угп: угп
стакан: стакан стакана
снижаться: снижается
вступительный: вступительными
космический: космических космическом
руст: руста
выставка: выставка выставок выставке
свидетельство: свидетельству свидетельств
китай: китай китая китае китаю
автономный: автономная автономной
увеличить: увеличило увеличить
нурмагамбет: нурмагамбетов
теолог: теологи
деревня: деревня деревне
ординатор: ординатор ординатором
пытаться: пытался пыталась пытаясь пытается
энергия: энергиях энергией энергии энергия энергий
производственник: производственники
юриевич: юрьевна юрьевич
издательство: издательством издательство издательстве
этнограф: этнографы этнограф
вдали: вдали
собирать: собирать собирал собирает
абдуахитович: абдуахитович
повреждение: повреждений
грузия: грузия
кафедра: кафедры кафедр кафедрой кафедрах кафедра кафедру
красный: красная
толчок: толчком
систематически: систематически
педиатрия: педиатрия
сотрудник: сотрудника сотрудник сотруднику сотрудниками сотрудником сотрудникам сотрудники
часто: часто
финансовый: финансовом финансовую
внешний: внешних внешнему
гербер: гербером
бедствовать: бедствует
тетракетон: тетракетонами
храниться: хранится хранятся хранившаяся
преподавать: преподавать преподавая преподавал преподавала
конус: конусами
тело: телах тела телом
преемственный: преемственно
гибнуть: гибнут
широкий: широк широкую широкому
восхождение: восхождении восхождений
реагент: реагентов
ленинград: ленинграде ленинграда
изобрести: изобретенная
романтизм: романтизма
район: районов района районе районах
терпеть: терпит
содержаться: содержатся содержался содержащуюся содержащимися
возникать: возникают
магистерский: магистерская магистерскими магистерскую
врач: врачей врач враче врача врачам врачом врачи врачами
ледник: ледников
получение: получению получением получения
диссертация: диссертаций диссертацию диссертацией диссертация
переписать: переписать переписал переписанная переписан
понимать: понимал понимают понимая
преобразование: преобразований преобразованиях преобразованиями
право: прав праве правам праву
клерк: клерк
сопровождать: сопровождал сопровождают сопровождает сопровождать
звание: званию званием звании
литва: литва литвы литвой
послать: послал послать
авив: авиве
действие: действиями действию действии действием действиях действий
среда: средой сред среду среды средах
лоренц: лоренца
кыргызский: кыргызская
инженер: инженеров инженера инженер инженеры инженером
кеш: кеше
завтра: завтра
открытие: открытия открытий открытием открытиям открытию открытии
век: веках века векам веке веков
статер: статеров
заявить: заявлено заявив заявил
сутки: сутки
толстикович: толстикович
кастрен: кастрену
уробилинурия: уробилинурия
госпиталь: госпиталя госпитале госпиталей
арбитражный: арбитражном арбитражному
композиция: композиция композицией
коммерсант: коммерсант
отвечать: отвечать
машина: машин
маг: маги маг магу
великий: великий великую великая
давать: дают давал давали дающая
страница: страницах страниц страницу страница странице страницам
снова: снова
комитет: комитетов комитета комитетами комитете
сосредоточиться: сосредоточился
временно: временно
бросить: бросила
киножурнал: киножурнала
ислям: ислям
авторитетный: авторитетные
блюм: блюмом
автомобилестроение: автомобилестроении
жуматаевич: жуматаевич
основать: основан основал основать основаны основано основала основанную
рассматривать: рассматривает рассматривал рассматривая
воздерживаться: воздерживаться
символ: символов
забан: забан
успеть: успел успела
присвоение: присвоением
оверхаузер: оверхаузером
эволюционный: эволюционная
западный: западная западнее западно западные
палеолит: палеолита палеолите
учредить: учредить учредило учреждена
префект: префектом
штат: штата штатах
основа: основе основам основой основами основу основ основа
лечь: легли
приводиться: приводится приводятся
филогенез: филогенезу филогенеза
осуществление: осуществления
подтвердить: подтвердили подтвердила подтверждено подтвердил
россия: россию россией россия
стремиться: стремиться стремился
одержать: одержал
хаммад: хаммад
художество: художеств
егоршин: егоршин
слой: слоем слое
бюл: бюл
приход: прихода
степан: степан
динозавр: динозавров динозавра
соавт: соавт
грант: гранта грантов
профессоракадемик: профессоракадемик
отрывок: отрывков
выборы: выборах выборов
тип: типа типами типов
теория: теория теорию теорией теорий
великобритания: великобританию великобритания
демонстрация: демонстрацию демонстрациях демонстрация
планировать: планировал
свен: свен
читатель: читатель
биография: биография биографий
упразднить: упразднена
казашка: казашкой
кандидат: кандидаты кандидатом кандидатов кандидат
внедрить: внедрены внедрен внедрена внедрил
навук: навука
высказывать: высказывал
волна: волн волна
известность: известность
второй: вторая вторую
матрица: матрица
думка: думка
организовывать: организовывала организовывали
анатомия: анатомию анатомия
акоп: акоп
уезд: уезда уездах уезде
период: периода периодом период
наука: наукой науки науках наука наукам наук науку
переменный: переменная переменными
птолемей: птолемей
суд: суде судом суда судах
эволюция: эволюции эволюция
густав: густавом
полупустыня: полупустынь
совма: совм
профессор: профессорами профессор профессору профессором
завод: заводах заводе заводов завода
раствориться: растворился растворится
превращение: превращений
наркомат: наркомату
привлекать: привлекает привлекал
послужной: послужная
средний: средний средняя среднюю
память: память
пещера: пещер пещере
епископ: епископ
сепсис: сепсиса
независимый: независимые независимыми независимый
учитель: учитель учителем учителями учителю
журна: журн
слуховой: слуховыми
кисловодск: кисловодска
эндокринолог: эндокринолог эндокринологи эндокринологом
диск: диска диску
томас: томас томасом
рабинович: рабиновичем
смочь: смог
средство: средств средствами средство
спаситель: спасителя
фергюсон: фергюсон
популярность: популярностью
поездка: поездку поездок поездках поездки
давид: давид
бихта: бихт
экологический: экологических экологическая
оружие: оружием оружия
просьба: просьбой просьбе
ядерный: ядерных ядерную ядерная ядерно ядерного
глюк: глюка
изображать: изображает изображать
удаваться: удавалось
архивариус: архивариус
испытание: испытаниям испытанию испытаниями испытаний
капиллярный: капиллярно
ответственный: ответственна
линейный: линейная
жильё: жилья
завершение: завершении завершение завершения
измена: измену
зависеть: зависит
всасывание: всасывании
тысячелетие: тысячелетий тысячелетии
караимовед: караимовед
проект: проекту проектах проекте проектом проекта проектами проектов
патоморфолог: патоморфологи патоморфолог
расцвет: расцветом расцвет расцвете
боеприпас: боеприпасов
металлург: металлург металлурги
переговоры: переговорах
литературовед: литературоведы литературовед литературоведах
скончаться: скончался скончалась
критиковать: критиковал
окружение: окружении
географический: географические географическими географическая географического
диалект: диалекта диалектом
чиновник: чиновником чиновников
способствовать: способствует способствовал способствовала
шмеркович: шмеркович
проверить: проверить проверена
оте: оте
масса: массы массу масс
очерк: очерке очерка
израилевич: израилевной израилевич израилевна
новгород: новгорода новгороде
отождествление: отождествление
корпус: корпусу корпуса корпусов
входить: входили входила входит входят входил
смерть: смертью
такой: такая таким
эффект: эффекту эффектом эффекта эффектов
дополнительный: дополнительная дополнительными дополнительном
мгма: мгму
предисловие: предисловие предисловием предисловии предисловий
дэниел: дэниел
ильич: ильича ильич
земледелие: земледелия
консультировать: консультировала консультировал
абрамич: абрамич
штутгарт: штутгарта штутгарте
одновременно: одновременно
женщина: женщина женщиной женщинах
применять: применять применял
принять: принято приняв принять приняла приняли принял
известный: известными известных известен известная известные известны известна
валеология: валеология
внесение: внесении
отсутствовать: отсутствуют отсутствует
полиномиальный: полиномиальными
пернов: пернове
участок: участках участке участком участков
бурхан: бурхан
усовершенствовать: усовершенствовать
вводить: вводит
задача: задачей задачу задачах задачам задачами задач
фрезеровщик: фрезеровщиком
аро: аро
сельский: сельских сельском сельского
голдин: голдин
гробница: гробниц
москва: москве москву москвы москвой москва
деннис: деннис
статус: статусом статуса
владимирович: владимировна владимирович
песня: песен
вдова: вдову вдова
эстония: эстония
недалеко: недалеко
физика: физику физики
шульц: шульце
пучок: пучком пучка пучков
реактор: реакторах реакторы реакторов
ленинградский: ленинградскую ленинградская
метод: методов методах метода методом методам
судья: судей судьям судье судья
георгиевич: георгиевич
богатый: богата
кварц: кварца
победа: победу победы
днепропетровск: днепропетровске
апостолат: апостолате
восточный: восточно восточная
истина: истины истина
благодарность: благодарностью благодарностями
спина: спина
поток: потоков потоками потока потоках
абиев: абиев
вгавма: вгавм
малахов: малахов
организация: организациями организацией организация организацию организациям организаций организациях
миллион: миллиона миллионов
оставаться: остаются остается оставаться оставался оставалось
киновед: киноведы киновед
самуел: самуел
радиотелеграфист: радиотелеграфистом
матвеевич: матвеевичу матвеевич
кислота: кислот
кливленд: кливленда кливленде
община: общиной община общину
иметься: имелась имеются
анализ: анализе анализу анализа анализом
белгородский: белгородская
коллегия: коллегий коллегиях коллегия
присвоить: присвоена присвоен присвоено присвоили
побудить: побудили
пройти: пройдя прошел пройти прошла прошли
экспертиза: экспертизы экспертизе экспертизу экспертиз
выступить: выступила выступил
юрист: юристом юристов юристы юрист юристах
вольск: вольске
принимать: принимать принимала принимал
судьба: судьбу судьба
кабинет: кабинете кабинета кабинетом
малогод: малолет
масштаб: масштабе
райком: райкома
промышленность: промышленности
металл: металла металлов
михаил: михаила михаил
выполнять: выполнял выполнять выполняя выполняет
надличностный: надличностную
америка: америки америке америкой
построить: построены построено построил построить построила
сенай: сенаи
рецензия: рецензий
представить: представить представлена представил представила представлены представлен
сулак: сулака
гидролиз: гидролизе
арест: ареста арест арестам
прозектура: прозектурой
масаиль: масаиль
интервал: интервале интервалов интервала
присутствие: присутствия присутствии
смотреть: см
аспект: аспектов
лучевой: лучевая
халафа: халаф
возложить: возложены
монета: монет монетах
больница: больницей больнице больница больниц больницу
академик: академик академиком академика академики
демобилизоваться: демобилизовался демобилизовавшись
основное: основном
берлинский: берлинском
сорбент: сорбента
норвегия: норвегию норвегия
уэльс: уэльсе уэльса уэльс
сфрагистичня: сфрагистични
называть: называют называет называл называли называемую называть называемого
зиновиевич: зиновьевич
португалия: португалией португалия
приоритет: приоритетом приоритету
естествоведение: естествоведению
орда: орд орда
февраль: февраля феврале
вуз: вуза вузов вузах вузе
боевой: боевую
симеон: симеон симеоне
функция: функцию функция функций функциях
добавление: добавлении
освободить: освободив освободила освободили
выявить: выявил выявлено выявить выявлены
преодоление: преодоления
таджикистан: таджикистана таджикистан
утрата: утратой
эпидемиолог: эпидемиологи
попытаться: попытаться попытался
казахстан: казахстана казахстане казахстану казахстан
бармин: бармин
решение: решении решений решению решением
смотритель: смотрителем
сравнение: сравнению
петрович: петровна петрович
бейкер: бейкер
рнб: рнб
шарлотсвиль: шарлотсвиле
киргизия: киргизия
борисович: борисовны борисович борисовича борисовна
кыргызстан: кыргызстана
ускорительщик: ускорительщики
статья: статья статье статьями статьям статьях статьи
королевский: королевскую королевская королевском
предприятие: предприятий предприятием предприятиями предприятию предприятии
нетрадиционный: нетрадиционная
позвоночный: позвоночных
коттедж: коттеджей
лондонский: лондонская
развивать: развивая развивает развивать развивал
отказаться: отказался отказавшись
минсельхозпрод: минсельхозпрода
захариас: захариас
англия: англию англия
стандартный: стандартными
побеждать: побеждать
профессия: профессию профессий профессия
лозанна: лозанны
информатика: информатика информатики
итф: итф
счастие: счастья
полимерный: полимерная
гарвардский: гарвардская
тритерпеноид: тритерпеноида
вода: вод водой воды
нумизматический: нумизматическая
жир: жиров жира
последний: последняя последними последних последнюю
ориенталист: ориенталист
тема: темам тему тема темами
аспирантура: аспирантуру аспирантура
стараться: старался
употребление: употребления
юбилей: юбилея юбилею юбилеев
впо: впо
обработать: обработан
правовед: правовед правоведы
корень: корней
тождество: тождестве
первый: первыми первая первую
вениаминович: вениаминовна
отец: отцом отец отцу
контекст: контексте
упорядочение: упорядочения
абхазия: абхазия
дворец: дворце дворцом дворца
ракетный: ракетная ракетных ракетно
арбитр: арбитр
израиль: израиля израилем израиле
оренбург: оренбург
спорт: спорту спорта спортом
комплекс: комплексам комплексов комплекса комплексах
исследователь: исследователе исследователями исследователь исследователя исследователи исследователям исследователем исследователей
некоторый: некоторая некоторыми некоторое
исправлять: исправлять исправлял
кладовщик: кладовщик
поддержка: поддержке поддержку
значительный: значительного значительную
момент: моментом момента момент
аппарат: аппаратов аппаратах аппаратам аппарата аппарате
гравитация: гравитация
особенность: особенностями особенностей особенностью особенностях
дониша: дониш
институт: институтом институтов институт института институте институтами институту
введение: введению введении
демон: демонов
новый: новую новыми новейшая новая
издать: изданы издана изданная издал издано издав издала издан изданную
идентичность: идентичности
поликетид: поликетидов
относиться: относятся относится относился
публичный: публичными публичная
порядок: порядка порядке
катализатор: катализаторах катализаторов
бактериолог: бактериологи бактериолог
популяризация: популяризацией
послужить: послужило послужила
ористогнозия: ористогнозия
детский: детская детском
борис: борисом борисе борис
трансэтерификация: трансэтерификацией
аналитический: аналитическая
наградить: награжден награждена наградил наградили наградило награждены
таджик: таджик таджики
энцыклапедычный: энцыклапедычны
маленький: маленький маленьком меньше
сюзанна: сюзанну сюзанной
космонавтика: космонавтики космонавтика
практиковать: практиковать практиковали практиковала
обобщение: обобщением
литератор: литератор литератором литераторами литераторы
млекопитающее: млекопитающих
фрэнсис: фрэнсиса фрэнсисом
айк: айк
юго: юго
кулагин: кулагин
жить: жила жил жить живет
юбка: юбками
духовенство: духовенством духовенства
политический: политическую политическая политический
ведать: ведая
карьера: карьеры карьеру карьера карьерой
грац: граце
древность: древностям древностях древностей
месроп: месроп
авазымыза: авазымыз
режим: режимов режиме режима
культурный: культурная культурного
достижение: достижениями достижений достижениях
переезд: переезда
педагогический: педагогическая педагогическую
непросто: непросто
натан: натан
столица: столицу столица столице столицей
включить: включена включил включила включены включен
отговорить: отговорил
столичный: столичных столичная
позволять: позволяла позволяло позволяет позволяют
находка: находка
исток: истоков
квартира: квартира квартиру квартире
мирдз: мирдза
сгу: сгу
соавтор: соавторы соавторами соавтор соавтором
нагорный: нагорно
заболевание: заболеваниях заболеваний заболеваниями заболеванием заболевании
берсукер: берсукером
показатель: показателей
абдушукур: абдушукур
эндогенный: эндогенная эндогенные эндогенными
театральный: театральная
сиб: сиб
персонал: персонала
начинаться: начинается начинался
коклюш: коклюша
моснаучтехобъединение: моснаучтехобъединении
богуславский: богуславский
кардиология: кардиология
занять: занял занять заняли заняла
фильм: фильмах фильме фильмов
еврейский: еврейская еврейскую еврейские
специалистка: специалисткой
интеграл: интегралам интегралах
чтение: чтениях чтении чтений чтения чтению
слово: слов словам словами
саул: саул
гуманизм: гуманизме
одевать: одевал
написать: написал написаны написала написанная написали написана написанную написан написано
нуль: нулю
наклон: наклона
отличаться: отличаться отличается отличаются
джордж: джордж
башк: башк
программа: программам программу программа программах программ
подать: подал
приурочить: приурочены приурочено
перечисление: перечислении
повышение: повышению повышения
композитор: композитор композиторы
поэма: поэма поэму
немец: немец немцами
иордан: иордана
комсомолец: комсомолец
существенный: существенны существенную существенна
вахтанг: вахтангом
определить: определены определить определил
навасардяный: навасардян
гамма: гамма
энгурра: энгурра
апартамент: апартаментов
организатор: организатором организатор организаторы
пилипович: пилипович
лаборатория: лабораториям лабораторий лабораторию лаборатория лабораторией
сконструировать: сконструировал
юм: юм
ирак: ираке ирака ираком
дольний: дольни
удостоить: удостоена удостоен удостоены
правление: правления правлением
поступление: поступлений поступлении
помещение: помещении помещений
эмигрант: эмигрантами эмигранты
петербургский: петербургском петербургская петербургскую
родственник: родственниках родственников родственники
археология: археологию археология
электрический: электрическими
почему: почему
любить: любит любил любила любят
римский: римская
живописец: живописца
обширный: обширную
яичко: яичек
деньга: денег
гильдия: гильдиям
матвей: матвей
событие: событий событию событиях событиями
экспедиция: экспедициях экспедиций экспедицию экспедиция экспедициями экспедицией экспедиции
произрастание: произрастании
авг: авг
ямр: ямр
предотвращение: предотвращению предотвращения
подвид: подвидах подвидов
полковник: полковник полковники
зафиксировать: зафиксированы зафиксировали
натерпеться: натерпелся
удовольствие: удовольствия удовольствием
наср: насра
српски: српски
концентрирование: концентрирования
значение: значении значения значениями
мерва: мерва мервы
язык: языками языков языком языках языке языка языку
налогообложение: налогообложения налогообложении
предпочтение: предпочтениями предпочтений
важный: важная важных важную важны важными важнейших
экоград: экоград
афористический: афористическими
астрономия: астрономия астрономию астрономией
ускоритель: ускорителей ускорителям ускорителя
выделить: выделен выделить выделил
далее: д далее
творчество: творчества творчестве творчеством
приобщить: приобщил
частица: частиц частицах
вашингтон: вашингтон вашингтона вашингтоне
стоять: стоял
николаевич: николаевич николаевна николаевне
пневмония: пневмониями
октябрь: октябре октября
должность: должностях должностей
магнитка: магнитки
поставить: поставил поставив поставлена поставлены
наварра: наварра
шаблон: шаблонах шаблонами шаблонов шаблона шаблоном
замысел: замыслу замысел
переводчик: переводчик переводчиком
главврач: главврач
неизвестный: неизвестны неизвестна неизвестен неизвестными
милтон: милтоном
массачусетс: массачусетса массачусетс
указание: указаний указанию указанием указаниям
саратовский: саратовская
астроном: астрономе астрономы астроном астрономах астрономами астрономом
подробный: подробнее подробная
копал: копале
торговля: торговли торговля торговлей
коллега: коллеги коллегами
полигон: полигона
психология: психология психологию
буланда: буланда
зеландия: зеландия
ввести: ввести ввели ввел введена введя введен
контроль: контролю контроля
явление: явлений
лебедь: лебедь
местность: местностей
комната: комната комнатой
плазма: плазмой плазмах
понять: поняты понять
кадровик: кадровики
ивр: ивр
этногония: этногония
ксенофонтович: ксенофонтович
паскаль: паскаль
заселить: заселить
редкость: редкостях
практиковаться: практиковалась
губернатор: губернатор губернаторах губернаторе губернатором
цефалоспорин: цефалоспорин
здравоохранение: здравоохранения здравоохранении
крит: крита крите
наблюдение: наблюдением наблюдений наблюдению
патологический: патологическая патологическую
абельман: абельманом абельману
параллельно: параллельно
связать: связаны связать связано связана
территория: территорию территория территорий
первоначально: первоначально
семёнович: семенович
ракета: ракетой ракет
объединить: объединил объединили объединить
говориться: говорилось говорится
канада: канады канада канаде
элм: элм
испытать: испытало
отв: отв
трудовой: трудовую трудовая
обвал: обвала
заболеть: заболел
агроэкосистема: агроэкосистем
прайс: прайса
биолог: биологи биолог биологе биологах
дагестанский: дагестанская
заинтересоваться: заинтересовались заинтересовалась заинтересовался
соотносить: соотносят
офтальмолог: офтальмологи офтальмолог
оказать: оказал оказав оказало оказала
воздействие: воздействия воздействии
подросток: подростков
бриолог: бриолог бриологи
мозг: мозга
муж: муж мужем мужу мужам
расположить: расположена
группа: группой группы группу группами групп группа
православие: православии
спелеолог: спелеологи спелеолог
продуктивный: продуктивную
ведомость: ведомости ведомостях
расстрел: расстрелу
ссылаться: ссылаются ссылаясь ссылается
экспрессивный: экспрессивная
ндр: ндр
оксфорд: оксфорде оксфорда
производитель: производителя
ак: ак
семинар: семинаров семинаром семинарах семинары семинаре
австрийский: австрийская
отыскать: отыскали
прохождение: прохождении прохождения
татарстан: татарстан татарстане
касаться: касаются касается касались
хребет: хребта
один: одну одна
завет: завета
подготовить: подготовлено подготовил подготовлены подготовила подготовили подготовлен
вид: видами вида видов виде видом видам видах
подготовка: подготовкой подготовку подготовки
русский: русская русском русские русскую русскими
переименовать: переименована переименован
компаративист: компаративисты
радиус: радиусе
утратить: утратил утрачено
раскопка: раскопках раскопок раскопками
председатель: председателем председателя председателе председатель
север: севера северу
письмо: писем письме письму
подданство: подданстве
вести: вела ведут
наш: наша
ядро: ядер ядрах
самарканд: самарканде самарканда
игнатий: игнатий
декабрь: декабре декабря
доктор: доктор доктором докторе
нарушаться: нарушаться
наряду: наряду
корректировка: корректировка
эрмитаж: эрмитажа
представитель: представителем представитель представители представителю представителей представителями
отслужить: отслужил
нак: нак
роберт: робертом роберт
константиновский: константиновская
каир: каира
дорожный: дорожного
вычислительный: вычислительная
клиника: клинике клиниках клинику клиникой клиника клиникам клиник
вогул: вогулам
посвящаться: посвящается
кэв: кэв
двадцать: двадцати
техникум: техникума техникуме
индивид: индивида индивидов индивид
пристрастный: пристрастен
белоруссия: белоруссия
взгляд: взглядах
журналист: журналисты журналистам журналистов журналист
бк: бк
кадий: кадий
классический: классическую классических классическая классическими
свойство: свойстве свойств свойствах свойством свойствами свойствам
восстановить: восстановить восстановил восстановило
гора: гору горах
политика: политику
вознесенск: вознесенске
сложный: сложными сложная сложную сложнее
пятигорье: пятигорья
мгнота: мгнот
помолог: помолог помологом помологи
старовойтов: старовойтов
зенитный: зенитно
правовой: правовом
поступить: поступить поступила поступил
изучение: изучением изучению изучении изучения
обобщать: обобщающую
сеять: сеют
пг: пг
научиться: научился научиться
снк: снк
яйцо: яйцах
аул: аула
леван: леван
федеральный: федеральная федеральном федеральное
совершить: совершить совершил
указать: указал указано указала указан
явиться: явилась явились
трансформатор: трансформаторов
канон: канонов
стибер: стибер
лидерство: лидерство
турап: турапов
кронштадт: кронштадте
девичество: девичестве
народный: народно народного народная народных
палеобиология: палеобиология
батальон: батальонов батальона
сбор: сбору сбора
повторить: повторить
выразить: выразить выражена выразил
документ: документах документов
колмогоров: колмогоров
неполный: неполная
шимон: шимон
орден: орденов орденами орденом
цыганков: цыганков
реликтовый: реликтовая
психоанализ: психоанализом
оборудование: оборудованию оборудования
казторгодежда: казторгодежда
город: городе городу городом городах города городам городов
сюра: сюр
снискать: снискали
степень: степеней степенью
масягин: масягин
саммит: саммита
присудить: присудила
ияф: ияф
шварцкопф: шварцкопфом
представлять: представлял представляло представляла представляли представляет
хнаф: хнаф
перебраться: перебравшись перебрался
структура: структур структуру структура структурами структурой
патмич: патмич
звать: звали
вычисление: вычислении вычислений
табличка: табличку табличка
мехмет: мехмет
пристроить: пристроено
инициативный: инициативную
компьютер: компьютерах
деятельность: деятельностью
король: король королей королю короля
иллюстрий: иллюстрием
жена: жены жене жену жена женой
потребность: потребностями
технология: технологий технологию технология
рост: росте роста росту
любезный: любезную
железный: железная
брайан: брайан
аветикович: аветикович
открыть: открыть открыт открыл открыв открыли
макмиллан: макмилланом
юда: юда
париж: париже парижа
отличие: отличием отличие
гданьск: гданьска гданьске
улучшиться: улучшилось
гражданин: граждан гражданином гражданина гражданин граждане
нн: нн
изобретатель: изобретатель изобретатели
библейский: библейскую библейская
приняться: принялся
проявлять: проявляют
хим: хим
евг: евге
генерал: генерал генерале генералы
калить: калила
туда: туда
уролог: урологом урологи уролог
слуцкий: слуцкий
архивист: архивистом
павлович: павлович павловна
показывать: показывает
скрывать: скрывая
деятель: деятели деятель деятелях деятелем деятелей деятелю деятеля
разделяться: разделяется
набрать: набрал
развиваться: развивался
фундаментостроение: фундаментостроении
поверхность: поверхностей
мелахим: мелахим
дух: духе
заняться: заняться занялся
хроника: хроникой хроника
спортивный: спортивна спортивная
агропочвоведение: агропочвоведения
рождение: рождении рождения рождений
аальст: аальсте
посольство: посольству
зап: зап
привнести: привнес
полуостров: полуострове полуострова
нед: нед
худжанд: худжанда худжанде
политцер: политцер
приз: призом
оценить: оценить оценены
пример: примерах примера примере
диспергирование: диспергирования
сингапур: сингапуре
полиэлектролит: полиэлектролитов
объект: объектов объектом
кусок: куску
надпись: надписей
покровительство: покровительством покровительству
отправиться: отправился
совершенно: совершенно
витковский: витковский
примерно: примерно
пароход: пароходе пароходов
онкологический: онкологическая
тобиаш: тобиаш
экстракт: экстракте
доход: дохода
освобождение: освобождения
многолетний: многолетнюю многолетняя
красавица: красавицы
биохимия: биохимией биохимия
удивление: удивления
войско: войсками войск
палата: палаты палате палат
хвойный: хвойно
спад: спада спаде
удовлетворять: удовлетворяет
энсиклопедияй: энсиклопедияи
абибуллаев: абибуллаев
психолог: психологе психологи психолог психологах
стб: стб
перфильев: перфильев
дрозд: дрозды дроздах
схи: схи
основывать: основывает
крик: криком
мехмат: мехмата
родитель: родителям родителей родителями родители
поставка: поставкам
циам: циам
короткий: короткая
печать: печатях печатей
сценарист: сценарист сценаристы
техника: техники техник техника технику
уголь: угля
премия: премий премией премия премию премии
шесть: шести
михаилович: михайлович михайловна
пониматься: понимается
очистка: очистка
стоматология: стоматология
поступать: поступает
бух: буха
размещение: размещения
стоматолог: стоматологом стоматолог стоматологи
сотрудница: сотрудница
пробуждение: пробуждению
передача: передачи передач передача передаче передачей
сталинград: сталинграда сталинградом
географ: географ географе географом географах географы
зальцбург: зальцбурге
возвращаться: возвращаться возвращается возвращался
гербарий: гербариев гербария гербарию гербарием
орбита: орбиту
доказательство: доказательствах доказательстве
футбол: футбола
устройство: устройств
балканы: балканах
служба: службу службам службы служба службой
одесса: одессе одесса
ереван: ереване еревану еревана
список: списка списке списках списком
синантропизация: синантропизация
арабский: арабская арабскую
член: членом членами член члены
диспансер: диспансера
направление: направлениями направлению направлениям направлении направлений
силикат: силикатов
швеция: швецию швеция
команда: команду командой
вормс: вормсе вормса
закончить: закончены закончив закончили закончил закончена
мединститут: мединститута
состояние: состояния состоянию состоянии состояний
историография: историография историографией
дзе: дзе
выходец: выходцами
концептуальный: концептуальную
правка: правок правка
завоевание: завоевании завоеванием завоеваниям
обслуживаться: обслуживаются
порода: породах порода пород
модернизация: модернизация
итк: итк
авиационный: авиационная авиационную
оставить: оставить оставив оставил оставило оставлен
издержка: издержках издержек
минск: минске минска
использование: использовании использованию использования использованием
обоснование: обоснования
математик: математиком математик математиков
джангирович: джангирович
приготовить: приготовить
вручить: вручил вручена вручен
армин: армином
павел: павла павел
ний: ний
поэзия: поэзия
переехать: переехал переехать переехала переехав
этаж: этаже
гулевич: гулевичи
раздел: разделами разделе раздела
акроним: акронимом
универсальный: универсальная
медик: медике медик медиках медики
прислать: прислал
векторный: векторно
луна: луне
лидер: лидер лидером лидера
спасти: спасти спасите спасены
саймон: саймоном
мамдуда: мамдуд
михма: михма михм
анастас: анастас
продолжать: продолжать продолжает продолжали продолжал продолжала
обработка: обработки обработку обработка
ангелович: ангелович
редактирование: редактировании редактированием
сильный: сильное сильнее
визуализация: визуализация
убедить: убеждена убедил
владивосток: владивостоке
возраст: возрастом возрасте возраста
директор: директором директор директоров директору
рахмон: рахмон
цюрих: цюриха цюрихе
линчей: линчеи
идрис: идрис
альманах: альманахе
оказывать: оказывал оказывает
депутат: депутатов депутатом депутат депутаты
статический: статическими
сооснователь: сооснователь
инвестиционный: инвестиционную
соединение: соединение соединениях соединений
метр: метров
ущерб: ущерба
являться: являлась являясь являлись являлся является являются
законоучитель: законоучитель
традиция: традициях традиция традиций
хадисовед: хадисоведы хадисовед хадисоведах хадисоведом
оказаться: оказалось оказаться оказавшаяся оказалась оказался
утверждение: утверждению утверждениями утверждением
писать: писать писала писал пишет
кооператив: кооперативах кооперативам кооперативов
изучить: изучить изучил изучена
антибиотик: антибиотиков антибиотиками антибиотика
окончить: окончить окончила окончив окончил
доклад: докладами доклада докладом доклад докладов
препарат: препарата препаратом препаратов
дородницын: дородницын
воспоминание: воспоминаний воспоминании воспоминаниям
синолог: синологи синолог
копенгаген: копенгагена копенгагене
хрисанфович: хрисанфович
месяц: месяц месяца месяцев месяце
составление: составлении
одуванчик: одуванчика
обучаться: обучался
каток: катков
количество: количестве количества
акад: акад
туркестан: туркестана туркестане
интернатура: интернатуру
библиотечка: библиотечка
удостоиться: удостоился
участник: участниками участникам участником участника участников участник участники
нефрол: нефрол
шахтёр: шахтер
степь: степей
эрик: эриком
кончина: кончиной кончины
животное: животного животных животные
гонорар: гонорара
привести: привели привело привела приведены приведено приведена
подходить: подходила
анкара: анкаре анкара анкары
вар: варах
апшерон: апшерона
карцев: карцев
красивый: красивую
работать: работает работала работая работают работали работал работать
стажироваться: стажировался
вгу: вгу
александровск: александровска александровске
гипронефтемаш: гипронефтемаше гипронефтемаша
выгода: выгод выгоду
вира: вир
сельскохозяйственный: сельскохозяйственного сельскохозяйственную
именоваться: именоваться
чрезвычайно: чрезвычайно
поэт: поэты поэтами поэту поэтах поэтом поэт
вызывать: вызывают
аукцион: аукционе
публикация: публикацией публикаций публикацию
ялуторовск: ялуторовска
нормальный: нормальную
каталог: каталогах каталогу каталоге
вещь: вещах вещей
работник: работник работника работники работников
совершенствование: совершенствования совершенствованию
фонд: фонду фонда фондов фондом
нина: нина
гулять: гулять
шахматист: шахматистов шахматист шахматисты
нтиевич: нтьевна
опрос: опросе
гимназия: гимназия гимназиях гимназию гимназий
работа: работам работ работа работу работой работах работами
образование: образованием образованию образований образования образовании
маньчжурский: маньчжурскими
кавказский: кавказскими
император: император императора
вывезти: вывезен
затеряться: затерялась затерялся
журналистка: журналистка
железа: железы
карлович: карлович
прибыть: прибыл прибыла
защитить: защитив защитили защищены защитил защитила защитить защищена защищено
пруссия: пруссия
оставлять: оставляя оставляет оставляют
включительно: включительно
станкевич: станкевичем
гургенович: гургенович гургеновичу
идеология: идеологией идеология
урок: уроков уроке уроками
свой: своими свой свои
рокфеллер: рокфеллера
занесение: занесении
каспрович: каспрович
пашков: пашков
портовый: портовая
коллекция: коллекцию коллекция коллекциями
выйти: вышла вышло вышел вышедшая
познакомиться: познакомиться познакомился познакомились
прогнозирование: прогнозирования
шувалов: шувалов
афонс: афонсу
ноль: нолей
пул: пула
берлин: берлина берлине
понимание: понимания пониманию понимании
каунас: каунасе
развязать: развязав
пинкусович: пинкусович
договариваться: договариваться
бороться: боролась
молибден: молибдена
руз: руз
образ: образов образе образу образа образом
покрытие: покрытий
германский: германскую германская
одинокий: одинокую
старый: старому старо старая
товаровед: товаровед
похожий: похожую похожими
беларускать: беларуская беларускай
сумматор: сумматоров
заглавный: заглавная
маргарита: маргарита
кунзек: кунзек
выпуск: выпусков выпуском выпуску выпуска
опера: оперы
войти: войти вошла вошли
занести: занесен занесено
череп: череп черепе
новость: новостях новостей
заповедник: заповедников заповеднику заповеднике заповедника
планета: планета планеты планет
угаснуть: угас
пермский: пермскую пермском пермская
выступление: выступлений
фермент: ферментов ферменту
землеустроитель: землеустроителем
корф: корфу
округ: округа округов округе округом
летие: летия летию летием
писатель: писателя писателях писателями писателей писатель писатели
программировать: программировал
фотография: фотография фотографией
почка: почками почек почках
этногенез: этногенезе этногенеза
усовершенствоваться: усовершенствовался
вывод: выводу
многократно: многократно
ситуация: ситуация
беллетрист: беллетристы
пауль: паули пауля
австрия: австрия австрию
заместитель: заместитель заместителем заместители
приобщаться: приобщалось
термодинамика: термодинамика
гарольд: гарольд гарольдом
гинеколог: гинеколог
липецкий: липецкая
нахичевань: нахичевань
кисай: кисаи
аскар: аскар
подписать: подписал подписаны
хисматулин: хисматулин
показать: показал показали показано покажите показать
егор: егор
медицина: медицина медицины медициной медицину
укрыться: укрылся
антонович: антоновна
ки: ки
египет: египте египта
максура: максур
сообщить: сообщить сообщил
биоресурсы: биоресурсов
дневник: дневнике дневника
картина: картину картин
гейдельберг: гейдельберга
норвежский: норвежская норвежскую
мир: мире миру мира
герб: гербах
портал: портале
добиться: добилась добиться добился
модель: моделей моделью модель моделях
максимин: максимина
совмещение: совмещению
садриддин: садриддин
городской: городская
предел: пределах
разрушение: разрушения
тмк: тмк
клуб: клубе клуба
фикх: фикх
платонизм: платонизма
занятие: занятиях занятий
исключить: исключены
круг: круга кругов кругах
уничтожение: уничтожения
приближение: приближении
выпустить: выпустил выпущены выпустила выпущен
задание: заданий заданию
цбк: цбк
высказывание: высказываниями
владеть: владеет владел
социально: социально
парламентский: парламентская
латышский: латышская
физикохимик: физикохимик физикохимики
точка: точек точках точки точку точками точкой точка
перепечатать: перепечатан
освещение: освещения освещении
польский: польский польская польскую
мать: мать матерью
рижский: рижскую
осн: осн
брошюра: брошюра брошюр
законодательство: законодательству законодательства
автоморфизм: автоморфизмах автоморфизмов
беломорский: беломорская
склад: складах склада
лагутин: лагутин
синтаксический: синтаксические
нагой: наг
донецк: донецке донецка
сергеевич: сергеевича сергеевич
сообщество: сообществ сообществе сообщества сообществах
островок: островке
реакция: реакция реакцию реакцией реакций
попытка: попытку попыток попытка
выплата: выплат выплату
эконометрика: эконометрики
классовый: классовая
массачусетский: массачусетском
громадный: громадную
зо: зо
археологич: археологич
эдуард: эдуардом
имущество: имуществ имущество имущества
база: базе база
мелик: мелику
медаль: медалями медалью медалей
система: системы системах систему система систем
аппроксимация: аппроксимацию
феодализм: феодализма
фармакология: фармакологию
жертва: жертв
газопровод: газопровода
пульсация: пульсаций пульсациях
теза: тез
выпускник: выпускников выпускники выпускник
петербург: петербурге петербурга
смута: смут
конгресс: конгрессе конгрессов конгрессах конгресса
прокурор: прокурора прокурором
елизаветинский: елизаветинская
оно: оно
телеканал: телеканале телеканал
увольняться: увольняясь
шахматный: шахматная
ивина: ивин ивина
эволюционист: эволюционист
носить: носит носят
сам: сама
флейтист: флейтист
глубинный: глубинная
овидий: овидий
коллекционировать: коллекционировать
популярный: популярными популярная популярных
класс: классах классов классе классу классы класса
учёный: ученая ученый ученые ученых
вступиться: вступился
каждый: каждая каждом каждые
кива: кивам
пуговичный: пуговичная
департамент: департамента департаменте департаментом
дидрахма: дидрахм
выстрел: выстрела
бетон: бетона
тов: тов
морфологический: морфологическая
теренозек: теренозек
автомобильный: автомобильную автомобильно
ххха: ххху
нарком: наркомом
лейден: лейдене
составлять: составлял составляло составляют составлять составляли составляла составляющих
проблематика: проблематику проблематика
характеристика: характеристика характеристик
армянин: армян армянами армяне
педвуз: педвузов
позиция: позицию позиция позиций позициях позициями
стратегия: стратегиях стратегия
динамика: динамика
проявляться: проявляется
пехота: пехота
итт: итт
прорвать: прорвала прорвали
март: марта марте
заметно: заметно
перевозка: перевозки перевозка
суворов: суворов
баршай: баршай
сау: сау
кавказ: кавказе кавказа
санжаровец: санжаровец
костиков: костиков
перселла: перселла
токарь: токарь
очаг: очагом очагов
эмиссия: эмиссия
сверхпроводимость: сверхпроводимостью
латвийский: латвийская
характер: характере характера
гражданство: гражданства
калининский: калининская
восшествие: восшествием
разделение: разделения разделение
абовить: абовя
австралийский: австралийские австралийскими
вооружение: вооружение вооружения
выражаться: выражается выражаясь выражался
администратор: администраторам
поляризация: поляризацию поляризация
иран: иран иране ирана
роман: романа
написание: написании написанию написания написанием
бумага: бумаг бумаге
художник: художники художником художник художников
шестой: шестая
негро: негро
компания: компанией компания компаний компаниями
случайный: случайная
нотебоом: нотебоома
содействие: содействия
императорский: императорскую императорская императорском
тральщик: тральщика
иллирийский: иллирийскую
тонна: тонн
утром: утром
экскурсия: экскурсиях
мальчик: мальчик
пойти: пойти
юрис: юрис
йка: йка
вплоть: вплоть
поэтому: поэтому
карст: карста
зарубежный: зарубежными зарубежная зарубежных
хаус: хаусе
профсоюз: профсоюзов профсоюза
глаголев: глаголев
налбандяный: налбандяна
нишапур: нишапур
массовый: массовой массового
животновод: животноводы животновод
выгрузка: выгрузка
придать: придали придал придать
мпр: мпр
год: годы годов годах лет году года годом
сельхозгиз: сельхозгиз
инновация: инновациями инновациям
десятилетие: десятилетий десятилетиями
узник: узниками
танкист: танкисты
дин: дин дину
волгоградский: волгоградская
обнинск: обнинска обнинске
иерусалим: иерусалиме иерусалима иерусалим
украсть: украдено
маджид: маджид
нобелевский: нобелевской нобелевская нобелевскую
кавалер: кавалер кавалеры
закончиться: закончилась
регулирование: регулирования
редкий: редкая редкие
литовский: литовская
биогра: биогр
стиль: стиля стилем
нейтральный: нейтральная
температура: температур температурах температурой температуры
многообразие: многообразий
спектроскоп: спектроскопа
ге: ге
алексей: алексей алексее алексея
сообщать: сообщают сообщать сообщал
предпочесть: предпочел
абдурахма: абдурахма
объединение: объединений
памятник: памятнику памятником памятниках памятников памятникам памятнике памятника
аминокислота: аминокислота аминокислот аминокислоту
суммирование: суммированием
коллектив: коллективами коллективом коллектива
футурологический: футурологическая
постепенно: постепенно
нейтрон: нейтронах нейтронов нейтронами
радиолокация: радиолокация
мощность: мощностью
видеть: видели видеть видит видело
биограф: биографом биограф
геоботаник: геоботаник геоботаники
погребение: погребениях погребений
очный: очную
награждение: награждении
выписка: выпискам
гин: гин
анасян: анасян
специализироваться: специализируясь
бан: бану
библиотека: библиотекой библиотеку библиотек библиотека библиотеках
йоханнес: йоханнесом йоханнес
микросфера: микросфер
лектор: лекторы лектор лектором
критически: критически
енох: енохом
ливерпуль: ливерпуле
совершать: совершал
воспитатель: воспитателем
рассказать: рассказал рассказала
знать: знаю знай зная знал знаем
ствол: стволов
калифорнийский: калифорнийском
присуждение: присуждении присуждению
фольклорный: фольклорная
реформа: реформ реформой
ицхак: ицхак
гематурия: гематурия
вера: веры
неолит: неолита
тпп: тпп
применение: применении применения применением
защита: защиту защитой защиты защита
сторона: стороны сторону
шота: шота
способность: способностям
суннит: суннитом
агрономия: агрономия
хабиб: хабиб
загреб: загребе загреба
сделаться: сделался
раунд: раунда
контур: контурами
армения: армения
марза: марза
метель: метелях
активный: активные активную активных
алгебраист: алгебраисты
итог: итогов итогам итога итогом итоге
рахим: рахимом
серебряный: серебряная
дипломат: дипломат
предпринимать: предпринимает
получать: получаем получали получают получает получал
вернер: вернер
ннг: ннгу
комод: комода
кровь: крови
использоваться: использовался используется используются
вроцлав: вроцлаве
синус: синусов
задаться: задался
прервать: прервал прервала
пенобетон: пенобетона
параллакс: параллаксов
мурчисон: мурчисоном
обладатель: обладателем обладатель
назначение: назначения назначений
встретиться: встретился встретились
френкель: френкелем
бруклин: бруклине
сто: ста
роддом: роддоме
шотландский: шотландская
отмечать: отмечает
горьков: горьков
кираат: кираат
суматра: суматра
папа: папы
заходнять: заходняй
управление: управлении управлением управления
казахский: казахская
чейн: чейном чейну
веймарский: веймарская
триада: триад
сочинение: сочинению сочинением сочинении сочинений сочинение
польша: польши польша польшей польшу
рнф: рнф
выделяться: выделялись
строительство: строительстве строительства
тауссиг: тауссиг
приобрести: приобрела
обобщить: обобщены обобщив
вильгельмович: вильгельмович
гим: гим
дом: доме домах
гимнастика: гимнастику
доставка: доставки
квалификация: квалификация квалификации квалификацией
способный: способен способны способная
награда: наград награда наградами
государственный: государственную государственными государственном государственных государственная
караманович: караманович
торговец: торговцем
отношение: отношению отношении отношений отношениями отношениям
авт: авт
природопользование: природопользования
маркус: маркус маркусом маркуса
революционный: революционную революционных
шеститомный: шеститомная
неоднозначный: неоднозначными
священный: священная
новочеркасский: новочеркасскую
школьный: школьны
галкин: галкин
моллюск: моллюск
физик: физиком физик
грамматика: грамматикой
сторонник: сторонник
обратиться: обратились обратился
дов: дов
пьянство: пьянством
взрыв: взрывов взрыва
племя: племени племенами племен племенах
затем: затем
шёрстный: шерстно
абрагам: абрагам
расположение: расположения
доказать: доказана доказал доказать доказано
провести: проведено провела провел провести проведены
магнитогорск: магнитогорске магнитогорска
племянник: племянники племянник
сюда: сюда
центральный: центральная центральную
ископаемый: ископаемую
оксана: оксана
геохимик: геохимик
памятный: памятная
исторический: историческая исторических историческую историческими
василий: василий василия василием
италия: италия италию
забайкалье: забайкалья
дар: дара
напряжение: напряжения
лут: лут
учебный: учебная учебно учебными
врасти: вросли
оккультный: оккультно
аграрный: аграрная
инквизитор: инквизитором
разрешение: разрешению разрешения
чей: чьи чья
состав: составе составом состава составов
тургенев: тургеневе
жан: жан жана
урочище: урочищ
кирсанов: кирсанова
сарикамыш: сарикамышем
таранушич: таранушич
ваграм: ваграм
петер: петер
олень: олень олене
исследовательский: исследовательскую исследовательская исследовательскими
кинофорум: кинофорума
стрелка: стрелка
полный: полная полную полными полного
атом: атомах
помочь: помочь поможете помогли помогите помогло
законовед: законоведом законовед законоведах
калам: калама
рынок: рынке рынка
болдинский: болдинская
воинский: воинскую
пекарный: пекарна
колос: колоса
таблица: таблиц таблице
найти: найти найдено нашел
посылать: посылал
глава: глава главе главах
селекция: селекция
фуат: фуату
проработать: проработали проработав проработал
сегетальный: сегетальная
алфавит: алфавиту
обязанность: обязанностей
экспериментатор: экспериментатором
парткабинет: парткабинета
аргентина: аргентины аргентина
быт: быте быта
тиэ: тиэ
стандарт: стандартов стандарту стандарта
цивилизация: цивилизация цивилизаций
фарра: фарра
этот: эта этими
патогенез: патогенезе патогенеза
хронологический: хронологическом
отправить: отправили отправлен отправлена отправил
феликс: феликса феликс
абонеев: абонеев
печатать: печатал печатать
санаторный: санаторно
мемуары: мемуаров
информация: информация информацию информации
минздрав: минздравом минздрава
установление: установления
заведение: заведениями заведений заведениях
постола: постола
солнечный: солнечных
абидович: абидович
розный: розен
горисполком: горисполкома
раскрытие: раскрытии
повыситься: повысился
лисичанск: лисичанске
психбольница: психбольницу
грей: грей
комилджон: комилджон
мудрец: мудрецом мудрец
фрактальный: фрактальная
заключать: заключает
книга: книгами книг книгам книге книга книгу книгой книгах
сон: снах
отображение: отображениях
двор: дворе двора
контракт: контрактом контрактами
стабильный: стабильная
шевелев: шевелев
тор: тором
франция: франция францию
аблабие: аблабием
поздний: поздними позже поздняя
определитель: определителя
базеять: базеян
джаф: джаф
волокно: волокно волокон
программный: программного
опираться: опирался опирались
значимость: значимостью
запрос: запросам запросу
гинзбург: гинзбургом
доверие: доверия
майкл: майкл майклом
окончательно: окончательно
умн: умн
распознавание: распознаванию
упоминаться: упоминается
марийский: марийская
прибор: приборов приборе
альянс: альянса
принятие: принятия принятию
копия: копия копию
воспитание: воспитания воспитанием воспитанию
исправить: исправить исправил исправив
комментарий: комментариев комментарием комментариях
исполнение: исполнению исполнении
азербайджан: азербайджана азербайджане азербайджан
уре: уре
ленингра: ленингр
кость: костей
гарвард: гарварде
кратер: кратера кратер
азиат: азиат
основатель: основателей основатель основателем основателе основатели
азъять: азъял
пехотинец: пехотинцы
умереть: умер умерла
граф: граф
сарматский: сарматскую сарматская
юг: югу юга юге
хименес: хименес
неволя: неволе
афганец: афганцами
выбирать: выбирал выбирают выбирает
координировать: координировать
первооткрыватель: первооткрыватель первооткрыватели
заключение: заключении заключений заключения заключению
констатация: констатацию
баба: баба
земляк: земляки
глобализм: глобализма
вопрос: вопросу вопросов вопросам вопроса вопросами вопросах
насилие: насилием
поощрение: поощрениями
нервный: нервных
тихий: тихом
тюрьма: тюрьме
реферат: рефератов
избрать: избрали избрана
сказка: сказкам сказка
мочь: могло могут могли могла можете мог
провинциальный: провинциальную
тюрк: тюрк
совещание: совещаний
фея: фея
урал: уралу урале урала
логический: логические
творческий: творческая
ташкент: ташкенте
инактивироваться: инактивируются
черепный: черепно
инерционный: инерционно
моммзный: моммзен
ссылка: ссылка ссылок ссылкой ссылками
ранее: ранее
й: й
цитирование: цитирований
заварзин: заварзин
педиатр: педиатр педиатром педиатры
дарвин: дарвина
житель: жителей жители
цензор: цензор
луксор: луксора
секретарь: секретарем секретарь
начинать: начинает начинал начиная начинали
инструктор: инструктором
проучиться: проучился
двигатель: двигателя двигателей
дослужиться: дослужился
рабочий: рабоче рабочая
пушкинист: пушкинисты
теоретически: теоретически
повесть: повестей
сизый: сиз
деталь: деталей
уильямс: уильямс
гермес: гермесом
серж: серж
вла: вла
валет: валет
профиль: профилями профиля
шухрат: шухрат
сдельный: сдельную сдельная
происхождение: происхождению происхождении происхождения
курский: курская
кфу: кфу
галерея: галерею
акр: акра
минута: минут минуты
противник: противником противник
коля: коля
преподаваться: преподавался преподаваться
гаага: гаага
саулович: сауловна
симбиоз: симбиоза
лучить: лучил
константа: констант
суперинтендант: суперинтендантом
июнь: июня июне
зооморфный: зооморфными
изображение: изображений изображениями
манжетка: манжетка
дебит: дебита дебитов
национализм: национализм
физ: физ
область: областями областью областях областям областей
высокий: высшая высшую высокая высоких
варшава: варшава варшаву варшавы
партийный: партийную
решать: решал
положить: положил положили
отвергнуть: отвергнуты отвергнута
орс: орса
федерация: федерация федерации федерацию
тургай: тургае
николаевский: николаевская
скульптурный: скульптурная
личность: личностей
гумбольдт: гумбольдта
уокер: уокер
лимож: лиможе
ординский: ординская
южный: южно южная
антифеодальный: антифеодальную
специалист: специалист специалистом специалиста специалистов специалисты
предположительно: предположительно
математический: математических математическую математическими математическая
предлагаться: предлагается
уточнение: уточнении
чита: чита читу
арефьев: арефьев
шок: шока
мишаилович: мишаилович
дума: думой
тимпан: тимпане
капитан: капитан капитаны
битва: битве битвы
крылов: крылов
учиться: учится учился учась учились учиться училась
справочник: справочников справочнике
рязгма: рязгму
голдман: голдманом
контора: конторой
акушерство: акушерстве акушерству
урологический: урологическую урологическая
тобольский: тобольскую тобольская
закрытие: закрытием закрытия
сектор: сектором секторе сектора
удаление: удаления удалению
миллисекундный: миллисекундными
осуществлять: осуществляет осуществляла
журнал: журналом журналу журнале журнала журналах журналов
природный: природно природная природного
встречать: встречает встречал
термин: термина термин терминов терминах
вырасти: выросла вырос выросло
робинсон: робинсон
скульптор: скульптор
перевезти: перевезено
преподавательский: преподавательскую преподавательская
восстание: восстании восстания
воссоединиться: воссоединилась
таврический: таврическая
расстрелять: расстрелян
ветеринарный: ветеринарная ветеринарную
нио: нио
ргп: ргп
семый: семее
зоология: зоология
принадлежать: принадлежат принадлежит принадлежал
фм: фм
слияние: слияния
концлагерь: концлагере
экономика: экономикой экономика экономики экономику
нейрохирург: нейрохирург
реагировать: реагируют
предпринять: предпринял
удивиться: удивился
соболезнование: соболезнования
еврей: евреи евреев евреях
посёлок: поселке
скорость: скоростях
сыворотка: сыворотка сывороток
подрабатывать: подрабатывать подрабатывая
наличие: наличии наличием
победитель: победитель победителем
шейный: шейна
иммигрант: иммигрантов
редактировать: редактировал
зимний: зимняя
указатель: указателю
тгу: тгу
шахта: шахт
галич: галича
музыка: музыка музыку музыки
падение: падении падения
планетарий: планетария
валентинович: валентинович
лицей: лицея лицее
конфликт: конфликту конфликтов
грунт: грунтах грунтов
школа: школ школах школу школе школа
играть: играть играют играл
элохим: элохимом
аргумент: аргумента
поволжье: поволжья
джавахир: джавахир
разрез: разрезе
взять: взят взял взято
пожертвовать: пожертвовать
массообмен: массообмена
информировать: информируя информировал
приложить: приложил
парта: партам партой
ниу: ниу
компонент: компонентом компонентов
подлинник: подлиннике
башня: башня
католичество: католичеством
навсегда: навсегда
фомич: фомич
инвалид: инвалидов
ифп: ифп
проецирование: проецирования
визит: визитов визита
беседовать: беседуя
расторгнуть: расторгнут
исаак: исаак
бек: бек
задавать: задавали
богослов: богослов богословы
дембец: дембце
минвнешторг: минвнешторга
абилович: абилович
одноклассник: одноклассником
ежегодник: ежегодника
ежедневно: ежедневно
традиционный: традиционных
амма: амма
предположить: предположил предположить
гот: готы готу
позть: позена
многочисленный: многочисленную
батарея: батарея
прокуратура: прокуратуры
семейство: семейства семействам семейств
охрана: охраны охрана
австралия: австралия австралию
лютый: люты
сплошной: сплошные
угодье: угодий
рб: рб
атлас: атласом
совмин: совмина
словарь: словарю словаря словарь словаре словарей
республика: республике республик республикой республики республику республика
челомей: челомей
каппа: каппа
иннис: иннис
оркестр: оркестра оркестре оркестрах
комиссар: комиссаром комиссара
произвести: произвести
шиитский: шиитская
екатеринославский: екатеринославская
обеспечивать: обеспечивающая обеспечивает
токсин: токсинов
тив: тив
самый: самая самую самое самых
специфика: специфика
паломник: паломники
архитектор: архитектор архитекторы
опыт: опыта опытов опыту
знаменатель: знаменателя
впервые: впервые
венгеров: венгеров
серебро: серебра
айя: айя
полуметалл: полуметаллам
москвин: москвин
нозьер: нозьер
кор: кор
тетания: тетания
яковлевич: яковлевич
празднование: праздновании
з: з
карагандинский: карагандинская карагандинскую
фактор: факторов
азар: азар
гемодиализ: гемодиализа
японец: японцами японцев
выделять: выделяют выделял
карбонатный: карбонатно
стекло: стекла
захарович: захарович
изменение: изменений изменениях изменении
тщательно: тщательно
чну: чну
защищать: защищала
женатый: женат
ивановский: ивановская
проявить: проявил
нагорье: нагорий
агрегат: агрегатов
фузариоз: фузариоза фузариозу
путешествие: путешествиях путешествий
тесно: тесно
моторист: мотористом
развить: развил
бизнес: бизнеса
аутизм: аутизмом
алексеевич: алексеевич алексеевна
нажать: нажав
самуилович: самуиловна
козоводство: козоводству
мишель: мишелем
перезахоронить: перезахоронено перезахоронены
рассмотреть: рассмотрел рассмотрит
экспансия: экспансия
действовать: действовать действовал
предание: преданиях преданий
привить: привил
церковь: церквях церквей
богатство: богатства богатств
каменный: каменная
такт: такта
швейцарский: швейцарская
кантианство: кантианстве
богородица: богородицы
паровой: паровая
промышленный: промышленными промышленных промышленная
планироваться: планируется
ислам: ислама
порок: пороков пороках
нит: ниту
функциональный: функциональная функциональных
длительный: длительного
легенда: легенде
незамужний: незамужняя
всеволод: всеволод
разведка: разведки разведка
очень: очень
мечта: мечта
колледж: колледже колледжа колледжу
шарх: шарх
аэродинамический: аэродинамическая
перевестись: перевелся
монокристалл: монокристаллами монокристаллом
уфа: уфа уфы
форма: форме формах форму форм
софия: софия
краеведческий: краеведческая
токсичный: токсичен
просветительский: просветительскую
татарский: татарская
ирригация: ирригация
запас: запаса
лаврентиевич: лаврентьевна
исмаиль: исмаиль
электроника: электроники электроника
наи: наи
средневековье: средневековья
доступный: доступными доступен доступна
фольклор: фольклора фольклору
порембович: порембович
применяться: применяется применяться
медицинский: медицинского медицинская медицинскую
неделя: недели недель
охватить: охватить охвачены
встраиваться: встраиваться
хронология: хронология
проникнуть: проникнуть
трок: троках
гевонд: гевонд
бм: бм
комиссия: комиссий комиссию комиссией комиссия
указ: указами указом
рисовать: рисует
высоко: высоко
мти: мти
энеев: энеев
нравственный: нравственную
священник: священники священник священника
подход: подходом
издание: издании изданию изданиях изданиям изданием изданий
абраам: абраам
подружиться: подружился
шуджа: шуджа
дополнить: дополнил дополнить дополнив дополнен
народ: народа народов народами
глазница: глазницу
создатель: создателем создатель создатели
выход: выходом выхода
мужчина: мужчиной
трия: трий
ммад: ммад
квадрика: квадрики
бал: бал
уравнение: уравнениям уравнениями уравнений уравнениях
свердловск: свердловске
башкирский: башкирскую башкирская
задействовать: задействован
угроза: угрозой угроз
металлогения: металлогения
костянтин: костянтин
кулешов: кулешов
медуниверситет: медуниверситета
ребёнок: дети детях
почвоведение: почвоведению
мацинович: мацинович
эрнст: эрнстом эрнст
археолог: археологом археологи археологам археолог
гянджумович: гянджумович
френкел: френкел
трактат: трактатов трактат трактате
панорама: панорама
брюссель: брюсселе
начальный: начальную начальная
тенденция: тенденцию тенденцией
бронкс: бронксе
просвещение: просвещения
всадник: всадник
археограф: археограф
убеждать: убеждает
таять: таять
механический: механических
самбор: самборе
пломбировка: пломбировка
розенталь: розенталя
подрод: подрода
артёмович: артемович
отечественный: отечествен отечественные отечественных отечественная
сбежать: сбежала
читать: читает читают читала читали читать читал
раить: раен
смилтенский: смилтенскую
захват: захвате захватом
подпорожье: подпорожья
перенять: переняв
вернуться: вернуться вернулись вернулся вернувшись вернулась вернутся
мсх: мсх
стипендиат: стипендиаты стипендиат стипендиатом
воронеж: воронеже воронежа
открыватель: открыватель
посетить: посетил
бояться: боясь
дефект: дефекты
кулиса: кулисами
совместно: совместно
владимир: владимир владимиром
сжатие: сжатию
сопутствовать: сопутствуя
сигнал: сигналов
нацизм: нацизма
фмш: фмш
сиркен: сиркен
скачать: скачать
физически: физически
бессарабия: бессарабия
ньютоновский: ньютоновскую
охарактеризовать: охарактеризована охарактеризовало охарактеризовал
окоп: окопа
разжевайкин: разжевайкин
независимо: независимо
земляничный: земляничная
спирин: спирин
статистика: статистика статистики
кислый: кислая
кво: кво
теллур: теллура
лаврентий: лаврентий
наумович: наумович
равнинный: равнинными
след: следам следов
якуб: якуб
репутация: репутация репутацию
казна: казну
масло: масел
кембридж: кембриджа кембридже
экстремум: экстремума
агасян: агасян
симферополь: симферополе симферополя
назвать: назвали назвав назвал
культивирование: культивировании
перс: перс
абрамян: абрамяну абрамяне абрамяном
широта: широт ш
иммиграция: иммиграция
петрозаводск: петрозаводске
кататься: катался
суспензия: суспензиях
место: месте местах мест
яковлев: яковлев
беларускаг: беларускага
приступить: приступило приступил приступить
зуфар: зуфаром
христианство: христианства
насир: насиру
нуждаться: нуждался
рэу: рэу
перейти: перешла перейти перейдя
вершина: вершину вершин
фармацевтический: фармацевтическая
квжда: квжд
единица: единице единиц
таг: таги
отдел: отдела отделом отделу отделе отделами
описание: описанием описанию описании
имя: именем именами
извлечение: извлечению
вищ: вищ
означать: означает
поселенец: поселенцев
кува: кува
сильно: сильно
чемпион: чемпионом чемпион
американский: американская американские американских
воспитывать: воспитывала
качество: качеству качестве
буш: буша
курсант: курсантом
гиперповерхность: гиперповерхностей
пометка: пометку
представляться: представляется
практический: практическую практическая практические
химический: химическая химических химическом
должный: должны должен должна
летний: летнюю летние
вернадский: вернадский
олигарх: олигарх
анат: анат
больницамозырский: больницамозырская
заряд: зарядом
функционал: функционала
предмет: предметам предмета предметом
понятный: понятными
руйиена: руйиена
биосинтез: биосинтеза биосинтезе
материальный: материальному материальная материальном материальных материальную
уровень: уровню уровнем уровня уровне
театровед: театроведы театровед
выбор: выбора выборе
турецкий: турецкая
альбумасар: альбумасар
монастырь: монастыре монастыря монастырей
интеллект: интеллекта
адвентивный: адвентивная
обсуждаться: обсуждаются
корифей: корифей
эмиграция: эмиграция эмиграцию
грамматик: грамматиком
цыбин: цыбин
антон: антону антон
европейский: европейскую
незначительный: незначительную
япония: японией япония
булгаков: булгаков
разведать: разведать
студень: студня
вотчина: вотчина
теплофизика: теплофизики
дверь: дверях
турция: турцию турция
атлетика: атлетика
пробыть: пробыл
вещество: веществ веществе
славист: слависты славист
составитель: составители составитель составителе
палеоэкология: палеоэкология
цфа: цфа
превышать: превышает
правоприменение: правоприменения
проходить: проходит
финский: финскую финская
охват: охватом
герой: герои герой
крест: крестом креста
стрелок: стрелком
маштоца: маштоца
ординатура: ординатуру
данные: данным данными данных
людмила: людмила
ширазийя: ширазийя
сессия: сессиях
венсан: венсаном
историк: историке историки историк историках историком
физикохимия: физикохимия
миннефтепром: миннефтепрома
ветеран: ветеранами ветеран
неразрешимый: неразрешимы
вихревой: вихревыми вихревая
оформление: оформлении
взрыватель: взрывателями
помнить: помним
создание: создании созданием созданию
культ: культом культа
ценить: ценить ценил ценят
леванович: леванович
остаток: остатков остатках
анкона: анкона
нидерланды: нидерланды нидерландах
тоннель: тоннелей
блондинка: блондинка
дивизия: дивизий дивизия
майор: майоры майор
мюнхен: мюнхене
подполковник: подполковник
эйлер: эйлера
луис: луис
кишечник: кишечнике
мбу: мбу
резиденция: резиденцию
кисель: киселя
красильников: красильников
сорбционный: сорбционная
памир: памире памира
крым: крыма
автор: авторы автора авторе автор автором автору
европа: европой европа европы европе европу
долго: долго
асир: асиром асир
представительство: представительстве
микроструктура: микроструктур
абель: абель абелем абелю
деруга: деруга
десятиугольник: десятиугольнике десятиугольника
кексгольм: кексгольма
кизика: кизика
перегон: перегоне
шек: шек
басра: басру басра басры
йиндржиха: йиндржиха
стимул: стимулов
тепло: тепла
иудаизм: иудаизма
преподаватель: преподаватели преподавателем преподавателей преподаватель преподавателям преподавателями
аппаратура: аппаратура аппаратуры
пётр: петр петра
диэлектрик: диэлектриков
голицын: голицын
окончание: окончания окончании
абидовауйти: абидоваушла
изомерный: изомерную
постановщик: постановщик
бодров: бодров
пост: постов пост посту
боз: бозе
аристакес: аристакес
делить: делил
александр: александр александром александру
весь: вся
ефрон: ефрон
арамович: арамович
анатолий: анатолий
ультиматум: ультиматум
семипалатинск: семипалатинска семипалатинске семипалатинску
абрамович: абрамовичу абрамовна
многий: многими
исламовед: исламовед
сетевой: сетевых
философский: философских философская философскими
эгида: эгидой
айова: айова
пенсия: пенсию
предсказание: предсказание предсказанию
особенно: особенно
йко: йко
выяснить: выяснить выяснил выяснила выяснена
католик: католики католиков католиком
инж: инж
харольд: харольд
отправляться: отправляется
александрович: александровны александровна александрович
архивировать: архивировано архивированная
норильск: норильске
преимущественно: преимущественно
обратить: обращены обратившая
ионофорез: ионофореза
июль: июля июле
хутор: хуторе
монгол: монгол монголами монголы
изыскание: изысканий изыскании
игра: игр играм играх
магистр: магистром магистр
китайский: китайская
доминиканский: доминиканскую доминиканская
библиографический: библиографическими
рр: рр
французский: французские французская французском
просмотр: просмотром
горпромторг: горпромторга
шатирян: шатирян
грушин: грушин
вейерштрасса: вейерштрасс
освоить: освоил освоено
усэ: усэ
фармацевтика: фармацевтику
долина: долин
выражение: выражению выражений
вульф: вульф
сменить: сменив сменил
артиллерист: артиллеристом артиллеристы
теодор: теодором
ши: ши
рельеф: рельеф рельефа
политолог: политолог политологи
алгебраический: алгебраическая
современник: современники современником
нц: нц
частый: чаще
почвовед: почвовед почвоведы
президент: президенты президента президенту президентом президенте президент
революция: революций революция революцией
линда: линда
цитироваться: цитировались цитировалась
оформить: оформить
эльт: эльта
сожалеть: сожалею
залив: залива
пять: пяти пять
арх: арх
фармаколог: фармаколог фармакологи
ркп: ркп
средиземноморье: средиземноморья
наступление: наступлении наступление
установить: установлен установить установлена установил установлены
подъёмный: подъемно
наблюдать: наблюдал
механизм: механизмов механизме механизма
гео: гео
инженерия: инженерия
шум: шумов
высота: высот
религиозный: религиозную религиозными религиозных религиозная
запустить: запущено
отборщик: отборщик
дудницын: дудницын
юма: юма
николай: николая николай николаем
эдинбург: эдинбурге
към: към
слиться: слились
гбу: гбу
янв: янв
изучать: изучать изучали изучала изучал изучая
каменогорск: каменогорска
официальный: официальная
палеобиологический: палеобиологических
лингвистический: лингвистическая
заложить: заложили заложил заложены
василиевич: васильевич васильевича
отражаться: отражается
хэ: хэ
собираться: собирался
осветить: освещены осветил
елизавета: елизаветы
готовый: готов готовы
сформулировать: сформулировал
рецепт: рецептов
ведомство: ведомства
коран: корана
ахмад: ахмад
налаживание: налаживанию налаживании
стих: стихов
недолго: недолго
триггер: триггером
иллинойс: иллинойсе
зайят: зайят
уоррен: уорреном
проход: проходами
метрополитен: метрополитена
уточнить: уточнил
идти: идет
собрать: собрала собрав собрал собраны
технический: технических техническую технического техническая
итальянец: итальянцев итальянцами
алетейя: алетейя
расти: рос
дальнейший: дальнейшая дальнейшем дальнейшего дальнейшую
влияние: влияния влиянием влиянии
выселить: выселить
жером: жером
хальберштадт: хальберштадте
мессина: мессину
саманид: саманидов
хандасийй: хандасиййа
развитие: развитии развитию развития
энциклопедист: энциклопедист
требоваться: требовался
геодинамика: геодинамика
аравия: аравия
ранний: раннюю ранними раннего ранняя
лола: лола
османский: османскими
семён: семен
судопроизводство: судопроизводства
дзюба: дзюба
иси: иси
высокогорье: высокогорий
полотно: полотен
желать: желая
калининград: калининграде
разъезд: разъездах
двуглазок: двуглазка
создавать: создавая создавать
причислить: причислен
кл: кл
педагогика: педагогику педагогика
запатентовать: запатентованы
блюменталь: блюменталя
мытищи: мытищах
преобразовать: преобразован преобразована преобразовали
эльвира: эльвира
белфаст: белфасте
вельямин: вельяминов
отстранить: отстранены
ритор: ритором
анион: анионах
корабль: кораблей кораблях корабля
каратель: карателями
аракел: аракел
краевой: краевая
идеалист: идеалист
кду: кду
мансур: мансур
областной: областную
ветеринария: ветеринария
духовный: духовного духовный духовная
присваивать: присваивают
медиевистика: медиевистика
тайга: тайга тайги
раз: раза разам
сотрудничество: сотрудничества сотрудничестве
зарегистрировать: зарегистрирована зарегистрированы зарегистрирован
похвала: похвалой
чми: чми
корона: короной
напиток: напитков
медленный: медленнее медленными медленные
борьба: борьбу борьбы борьба
сей: сих
сорокин: сорокин
раздор: раздорами
казначейство: казначейства
воспользоваться: воспользовавшись
роль: роли
настояние: настоянию
сырьё: сырья
иллюстрация: иллюстраций
разъяснять: разъясняет
гко: гко
приглашение: приглашения приглашению
голосование: голосования
мотославица: мотославица
комкор: комкоры
осуществить: осуществил осуществила осуществлен осуществлена осуществлено
восстанавливаться: восстанавливается
микрореактор: микрореакторы микрореакторам микрореакторах
запретить: запрещены
вклад: вкладом вклада
хозяйка: хозяйка
караим: караим караимы
продвижение: продвижению продвижения
спартакиада: спартакиад
наблюдатель: наблюдателем
нагрудный: нагрудными
рейтинг: рейтинга
начаться: началась
студа: студ
уволить: уволен
основоположник: основоположник основоположником
деп: деп
большинство: большинства большинство большинстве
карлстад: карлстада
сначала: сначала
григорий: григорий
презентация: презентаций презентация
атаман: атаман
открывать: открывает открывали
царский: царском
восток: востоке востока
символизировать: символизирует
большой: большому
завоевать: завоевал завоевало завоевав
фрейд: фрейдом фрейда
ранг: ранга
удаться: удалось
престол: престол
лексикограф: лексикографы лексикограф
бытие: бытия
уикхема: уикхем
ираноязычный: ираноязычными
львович: львович львовичем
выделиться: выделилась
высказать: высказал
словарный: словарная
бауман: баумана
дагестан: дагестана дагестане
микрокапсулирование: микрокапсулирования
моделирование: моделированию моделирования моделирование
пфайффера: пфайффер
литография: литография
далмация: далмация
окружить: окружены
путешественник: путешественник путешественника путешественники
як: як
применить: применил
бактерия: бактериях бактерий
фирма: фирмах фирма
протоиерей: протоиерей
даниял: даниял
пропадать: пропадал
муха: муха
знак: знака знаками
изгнание: изгнании
строение: строении строения
доминиканец: доминиканцев доминиканец доминиканцы
тахбир: тахбир
хоз: хоз
финансирование: финансированием финансированию финансирования финансировании
игрок: игроком игроков игрокам
ленинизм: ленинизма
формация: формаций формациях
стилистически: стилистически
несколько: несколько несколькими нескольку
никто: никому никто
ирина: ирину ирины ирина
соучредитель: соучредителем
добавить: добавить добавив добавил
покушение: покушений
отдать: отданная
ахмед: ахмед
палестина: палестины палестину
инспектор: инспектором
анатомический: анатомическая
знаменитый: знаменитые
джонсон: джонсон
прямоугольный: прямоугольно
разорить: разорена
экономизм: экономизма
собор: собора соборе
кэш: кэшем
переселиться: переселился
хирургический: хирургическую хирургическая
вильгельм: вильгельм вильгельма
шлях: шляхам
картирование: картированию
скважина: скважин
эльза: эльза
постсоветский: постсоветского
совпадать: совпадают
днепр: днепре днепра
шотландия: шотландия
хамид: хамид
утверждаться: утверждается
тезис: тезисов
сячинт: сячинтов
зы: зы
толстов: толстов
создать: созданная созданном создать создана создан создано созданы создал
путешествовать: путешествуя путешествовали путешествовал путешествовала
ян: яном ян
аспирант: аспирантам аспирант аспирантами
патронаж: патронажем
астролог: астролог астрологи
военачальник: военачальник
генеалогия: генеалогия генеалогию генеалогий
развенчивать: развенчивала
спч: спч
трудиться: трудиться трудился
иметь: имели имело имеет имеют имеющая имел имела
парламент: парламента парламенте
биология: биология
клетка: клеток
энц: энц
редколлегия: редколлегий
ковный: ковно
партия: партию партия
предварить: предварит предварено
вылет: вылетов
причинный: причинно
холм: холма холме
греция: греция грецию
хэл: хэл
лти: лти
изобретение: изобретения изобретений изобретении
катастрофа: катастрофа катастрофы
государственность: государственности
файл: файлах
камера: камере
рафикович: рафикович
императрица: императрицы
иммунологический: иммунологическими
капланбек: капланбек
начальство: начальством начальства
документальный: документальная
поручение: поручений поручению поручением поручениям
интерес: интересами интересах интересов интересом интереса
подчинение: подчинения
фазовый: фазовыми
адвокат: адвокаты адвокат адвокатом
хти: хти
подарок: подарка
телефон: телефонов
приказ: приказу приказ приказа приказом
бронза: бронза
биоразнообразие: биоразнообразия
исчезнуть: исчезла
форум: форума
серный: серно
открыться: открылась
мария: мария
новгородский: новгородскую
иц: иц
абарбанеля: абарбанеля
закрыть: закрыл
здо: здо
фара: фарах
краткий: краткая
фгб: фгбу
фгбнуть: фгбну
вычисляться: вычисляются
журналистика: журналистики
критический: критическая критических
фальк: фальком
уменьшаться: уменьшается
антибиотический: антибиотическую
концерн: концерн
догматический: догматическими
счесть: сочтена
денежный: денежная
алагёз: алагеза
фазылович: фазыловна
кремль: кремля кремле
азхар: азхар
клинический: клиническую клиническая клинический
отряд: отряда
новостройка: новостройках
оренбургский: оренбургская
малый: малая
суссекс: суссексе суссекс
тандалма: тандалма
руководитель: руководителей руководителями руководителем руководителях руководитель руководителя руководители
флавоноид: флавоноидов
разведчик: разведчики разведчик
лучица: лучица
накопление: накоплением накопления
женева: женеве
корреспондент: корреспондента корреспонденты корреспондент корреспондентом
зычный: зычны
стамбул: стамбуле
оккупация: оккупация
швейцария: швейцария швейцарию
иф: иф
пятый: пятая
африка: африки африке африка
соч: соч
абил: абил
владас: владас
эдмунд: эдмунд
причина: причин причиной причинам причинах
сассман: сассманом
резонансный: резонансная
считать: считают считает
однажды: однажды
лабораторный: лабораторная
каналирование: каналирования
акт: актов
саркис: саркис
сохранять: сохраняет
арестовать: арестован арестовали
теорема: теорема теорему теорем
кандидатский: кандидатская кандидатскую
рукопись: рукописях рукописей
растение: растений
проректор: проректором проректор
хирургия: хирургию хирургия
маяковский: маяковского
экстрагирование: экстрагировании
комбинат: комбината
технологический: технологическом технологических
объяснить: объяснил объяснить объяснила
эстонский: эстонская
баранников: баранников
нестор: нестора нестор
британский: британский британская британскую
мы: нами нам
мировой: мировая
чекановский: чекановский
биографический: биографическая
чечня: чечне
шамастиян: шамастиян
психоз: психоза
обнаружиться: обнаружилось
саратов: саратова
итл: итл
бутягин: бутягин
ликвидатор: ликвидаторы
асфар: асфар
записка: записках записок
тарих: тарих
зоя: зоя
внимание: внимания внимании внимание
юсуф: юсуф
этна: этны этна
курляндский: курляндская
альпинизм: альпинизма
приём: приемами
эфиопистика: эфиопистикой
школьник: школьником школьник школьникам
гражданский: гражданского гражданская
магнетизм: магнетизму магнетизма
признать: признало признали признаны
двести: двухсот
причерноморье: причерноморья причерноморью
деяние: деяниях
луцкевич: луцкевичу
метан: метана
бухара: бухара бухары
индивидуум: индивидуум
пелевин: пелевин
интерпретация: интерпретация
хроматин: хроматина
сценарий: сценария сценариев
х: х
возрождение: возрождения
характерный: характерно характерен
мёд: мед
кольцевой: кольцевыми
собака: собаках
боас: боас
изв: изв
формат: формате
сентябрь: сентября сентябре
сгибание: сгибанию
верный: верна верную
купец: купцом купца купец
глеб: глебе
лечение: лечению лечении лечения
занимать: занимали занимает занимая занимал занимала
оборот: обороте оборота
наполовину: наполовину
госуниверситет: госуниверситете
финансы: финансов
проверять: проверяема
гидрофобный: гидрофобную
пространство: пространства пространств пространствах
час: часе часа
халиф: халифу халифа
пополняться: пополнялся
пресса: прессе пресса
маслина: маслина
кинофестиваль: кинофестиваля кинофестивалях
благонравов: благонравов
цитировать: цитировать
содержать: содержать содержащую содержит содержал
микроаппарат: микроаппаратах
шестидневный: шестидневную
навредить: навредит
внедряться: внедрялись
транспортный: транспортная
джеймс: джеймс джеймса
ты: тебе тобой
украшать: украшала украшает
концепция: концепция концепцию
тузик: тузиков
подвергать: подвергая
распад: распаде распада
веда: вед
версия: версия версию
мастер: мастер мастерах
юраш: юраш
избиратель: избирателей
генерация: генерация
долгосрочный: долгосрочную
президиум: президиума
абрашкин: абрашкин
торговать: торговал
октябрьский: октябрьская
герметизм: герметизма
неописуемый: неописуемо
катализ: катализе
проникновение: проникновений
праздник: праздника праздников
нэш: нэшу
лист: листов листа
тарковский: тарковский
синтег: синтег
разделить: разделить разделена
калифорния: калифорния
фантастический: фантастическая
лифляндский: лифляндская
родство: родства
избрание: избрания
гринвич: гринвиче
совмещать: совмещая
фокусироваться: фокусируется
григор: григор
селекционер: селекционером селекционер селекционеры
прекратить: прекратить прекратил
хрестоматия: хрестоматия
сад: саду сада садах садом
встретить: встретил встретила
сведение: сведениям сведений
чл: чл
сеть: сетях сетей сетью
тюрин: тюрин
эмбрион: эмбрионов
фонталовский: фонталовская
дми: дми
золотой: золотую золотая золотыми
внести: внесены внести внес
бригада: бригада бригад
выслать: выслан
праздновать: празднуют
предназначить: предназначены предназначенных
сердце: сердца сердцами
музыковед: музыковеды музыковед музыковедом
возбуждение: возбуждения возбуждением
сокровище: сокровищ
орган: органами органов
иоахим: иоахим
безуглов: безуглов
ознакомиться: ознакомившись
тр: тр
каз: каз
почётный: почетная
котёл: котла
превосходство: превосходства
завершить: завершил завершить
воспроизвести: воспроизвела воспроизведены
лодка: лодок
мактьютор: мактьютор
программирование: программирования программированию
миллиард: миллиарда
протяжение: протяжении
интернат: интернате
иезуит: иезуитами
саат: саат
индийский: индийскую
словения: словения
оккультист: оккультисты
госкомитет: госкомитета
телешкола: телешкола
сен: сен
ихтилафа: ихтилаф
реиса: реиса
слишком: слишком
грузинский: грузинская грузинские
владычество: владычестве
филин: филин
ркк: ркк
рио: рио
схватить: схватил
склон: склоне склонов
предсказать: предсказал
другой: другую другими другая
оперативный: оперативная
ефанов: ефанов
рф: рф
помощник: помощником помощник
цв: цв
античный: античные античная
вход: входа
зак: заки
участвовать: участвовала участвовать участвовал участвовали участвует
рига: риге
гюкюлович: гюкюлович
ричардс: ричардс
макаревич: макаревич
искать: искали
хабилитация: хабилитация
торговый: торгово
аламейный: аламейна
основание: основаниям основаниях основанию основании оснований
библиотечный: библиотечная
симеонович: симеонович
лунь: луни
профилактика: профилактики
брэ: брэ
успешный: успешными
морис: морис
ор: оре
пребывание: пребывания пребывании
пояснить: пояснила
сейсмический: сейсмическую
аналитик: аналитиком аналитик
чечь: чечено
ма: ма
гонение: гонениях
породить: породили
челябинск: челябинска челябинске
отбить: отбил
удобный: удобную
ингредиент: ингредиентов
вулвич: вулвиче
альбуминурия: альбуминурией
различный: различными различным
страдание: страданий
гауна: гаун
новичихин: новичихин
подняться: поднялся поднялась подняться
сестра: сестру сестрой сестрам сестра
предупреждение: предупреждением
спор: спора споров
горпищеторг: горпищеторга
выдвигаться: выдвигался
воспитываться: воспитывался
ключ: ключом
хорезм: хорезма хорезме
широко: широко
гломерулонефрит: гломерулонефритов
тюркология: тюркология
связывать: связывают
соратник: соратник
чжэн: чжэн
персия: персию персия персией
легко: легко
художественный: художественная
проза: проза
статейка: статеек статейка
выброс: выбросом выбросов
вюртемберг: вюртемберге
вручать: вручает
саутгемптон: саутгемптоне
дополнение: дополнений дополнениями
новатор: новатор
раймонд: раймондом
католический: католическая католическую
биохимик: биохимик биохимики
ола: ола
основываться: основывался основываясь
ата: ата
биологический: биологических биологическая
вильно: вильне вильна
приписывать: приписывают
адъюнкт: адъюнкт
забой: забоев
уфн: уфн
карточка: карточка карточку карточек
передать: передал
самообразование: самообразованию
югославия: югославия
белорусовед: белорусовед
менее: менее
достигать: достигает
ованнисик: ованнисик
князь: князь князе
требовать: требует требуют
производить: производят производить производит
хх: хх
опухоль: опухолей опухолям
казак: казак
осмотреть: осмотрел
доучиваться: доучиваться
жих: жих
чудо: чудес
маутхаузен: маутхаузене
мариенбург: мариенбурга
ашляев: ашляев
пропаганда: пропаганду пропаганды
юрисконсульт: юрисконсультом
нумизмат: нумизматы нумизмат
невроз: неврозов
строитель: строители строитель
райнис: райнис
заменяться: заменяются
сербия: сербия
оксид: оксидов
трансформация: трансформацией
сравнительный: сравнительная
апрель: апреля апреле
столь: столь
ветер: ветер
грива: грива
иммунолог: иммунолог
ихр: ихр
углубить: углубить
востоковедение: востоковедению
шаг: шагом шага
трансект: трансект
нахман: нахману
музей: музеем музея музеев музее музею
генеральный: генеральным генеральный
трижды: трижды
шибкий: шибка
осаждать: осаждавшими
экономический: экономическую экономических экономическими экономическая
сингулярный: сингулярно
маслов: маслов маслова
легион: легиона
ленинский: ленинская
печататься: печатался
бакалавриат: бакалавриате
возведение: возведению
тува: тувы
электронный: электронных электронном электронно электронная
премьер: премьер
глиэр: глиэр
челести: челеби
улица: улицу улица улиц
крупный: крупнейший крупную крупнейшими
раскопать: раскопаны
муртазать: муртазали
окрестность: окрестностями окрестностях
девичий: девичью
религия: религия
послевоенный: послевоенная
неспециалист: неспециалистом
перо: пера
неопр: неопр
рыцарь: рыцарь рыцари
ближний: ближнем
аномалия: аномалий
джастин: джастин
осуждать: осуждала
переписка: переписка переписку
лес: лесов
хирург: хирургом хирурги хирург
корыстный: корыстными
зачислить: зачислен зачислили
укр: укр
зуб: зубов
библиогра: библиогр
равновесие: равновесию равновесия
вполне: вполне
кортлевер: кортлевера
доказывать: доказывал
буэ: буэ
анастасия: анастасия
валерий: валерий
сделать: сделано сделал сделана сделать
ференц: ференц
конституция: конституцией
рзэ: рзэ
обсерватория: обсерваторию обсерватория обсерваторией обсерваториях
иосиф: иосиф
чеш: чеш
услуга: услуг
приезд: приезда
представление: представлений
киргиз: киргизом киргизы
поместить: поместив поместил
теплообменник: теплообменникам
социальный: социальная социального
соперничество: соперничество
уральский: уральская
похвальный: похвальную
ухаживать: ухаживать
карабахский: карабахская
харбор: харборе
рий: рий
селекционный: селекционно
первопроходец: первопроходцем
вступить: вступил
разгореться: разгорелся
мов: мов
экспериментальный: экспериментальная
бальзамировщик: бальзамировщики
драматург: драматург драматурги
пешком: пешком
карда: кард
ме: ме
уединение: уединении
погос: погос
обслуживание: обслуживание
последующий: последующими
счёт: счет
доцент: доцент доцентом
тл: тл
светлана: светлану светлана
фрагмент: фрагментах фрагментов
стипендия: стипендия стипендию
фракция: фракций
село: селе
хорнунг: хорнунгом
товар: товаров товарами
районирование: районированию
адольф: адольф
пеноматериал: пеноматериалов
банк: банке банка
консультативный: консультативно
настоятель: настоятелем настоятель
расширяться: расширяется
диагноз: диагноза
опоздать: опоздало
миар: миар
дольф: дольф
полностью: полностью
языкознание: языкознанию
палец: пальцев
увлекаться: увлекался
абламович: абламович
астигматизм: астигматизма
присутствовать: присутствует
радянська: радянська
заметка: заметка заметок
станция: станций станцию станция
медичние: медичний
семья: семей семья семьи
два: двумя
рвк: рвк
кристина: кристину кристина
красота: красоты
газета: газету газет газетах газета
иля: иля
фабричный: фабрично
она: ею
зверь: звери
бриология: бриология
топограф: топограф
ставрополье: ставрополья
мера: мерой мер
наставник: наставником
гет: гетов
царь: царя царей
арарат: арарат арарата
сосудистый: сосудистыми
описывать: описывал описывающая описывает
платить: платят
баженов: баженов
коллективный: коллективную
ауб: ауб
квадрат: квадрате квадратов
оригинал: оригинале
обычай: обычаях
сим: симов
фаза: фазу фаз
сословие: сословиям
брест: бресте
низина: низина
горняк: горняк
тегеран: тегерана
усиление: усиление
поручить: поручено
методология: методология
улы: улы
благотворительный: благотворительные
мэр: мэром мэр
бакинский: бакинскую
недавно: недавно
историограф: историографом
лазание: лазанию
хенрик: хенрик хенриком
геологич: геологич
справочный: справочно справочная
вл: вл
побывать: побывал побывала
ориентация: ориентаций
ридберг: ридбергом
цент: центов
улучшить: улучшить
регресс: регресса
струя: струй
сохранение: сохранением сохранении
дальневосточный: дальневосточная
здание: зданием зданий
достоевский: достоевском достоевский
тиф: тифа тифе тифом
уделяться: уделялось
динамический: динамическую
подразделять: подразделяет
столкновение: столкновений
пора: пор
зритель: зрителю
сойтись: сойдясь
краков: кракова кракове
гаджиевич: гаджиевич
начало: началу началом начале
зенон: зенона
адуда: адуд
греческий: греческом греческих
овладеть: овладела
сокращение: сокращением
женитьба: женитьбы
зауралье: зауралья
курд: курды
моммзть: моммзена
калбить: калби
длиться: длился длится
константин: константин
чехия: чехию
контактировать: контактировать
итальянский: итальянская
петроград: петроградом петрограда
иоанн: иоанн
транспорт: транспорта
твен: твен
заграничный: заграничную
поселиться: поселилась поселился
франц: франц
самостоятельно: самостоятельно
жительство: жительства
показательный: показательную
чертёж: чертежей
доска: досках доска
выработать: выработать
ныне: ныне
пианист: пианистом
мама: мама
передел: переделу
вынести: вынести
христиания: христианию христиания
мадрид: мадриде
рассчитать: рассчитал
таксон: таксонов
уцелеть: уцелели
промысловый: промысловая
ябп: ябп
севастополь: севастополе
электропечатня: электропечатня
отдельно: отдельно
прага: праге
развестись: развелась
симпозиум: симпозиуме симпозиумах
курировать: курировал
здоровье: здоровьем здоровью здоровья
плод: плодов плода
астероид: астероидов
мох: мхов
рано: рано
липид: липидов
иу: иу
терек: терека
тысяча: тысяч
движение: движений движении движения
оболочка: оболочек
славянский: славянскую
бабушка: бабушка
учитывать: учитывающую
общественный: общественную общественная
мониторинг: мониторингу мониторингом
полухин: полухин
сопротивление: сопротивления сопротивлении сопротивлению сопротивлений
цефалопод: цефалоподах
становиться: становились становится
као: као
древнерусский: древнерусская
агроном: агроном агрономом агрономы
аналитически: аналитически
катод: катодов
районный: районную
лейба: лейба лейб
резец: резца
полпредство: полпредстве
знакомство: знакомство
смоленск: смоленске
бровка: бровка
выдержать: выдержали выдержал
вестр: вестра
дво: дво
студент: студентам студентами студентом студенты
васильович: васильович
аттестат: аттестате
прикладной: прикладная
сера: серу
верунться: верунвшись
катакомба: катакомбах
координатор: координатором
абакан: абакана
крашенинников: крашенинников
трава: трав
интеллектуал: интеллектуал
торндайк: торндайк
агентство: агентство агентства
кек: кека
лпи: лпи
газогенераторный: газогенераторная
ресурс: ресурсов
смысл: смысла смысле
михаэль: михаэлю
добыть: добыто
воздушный: воздушные воздушного
бледнеть: бледнеют
настолько: настолько
обвинять: обвиняет
фан: фан
зоопарк: зоопарке
джеральд: джеральдом
пациент: пациенты пациентов
твардовский: твардовский
регламент: регламентов
котбус: котбусе
наталья: наталья
чаплин: чаплин
удп: удп
шапочник: шапочником
бессрочный: бессрочную
бреславль: бреславля
литейный: литейно
типогра: типогр
барс: барс
следствие: следствие
курочкин: курочкин
альпина: альпина
хватать: хватало
беляев: беляев
белорусский: белорусскую белорусскому белорусском белорусская
минавиапром: минавиапрома
серг: серге
продать: продана
проводиться: проводится проводилось проводились
выставление: выставлении
навигация: навигация
независимость: независимость независимостью
персиковый: персикова
малиновский: малиновский
вспоминать: вспоминал
хорезмша: хорезмшах
ричард: ричард
имп: имп
ассоциация: ассоциаций ассоциация
талант: талантом
сложно: сложно
оценивать: оценивая
арвид: арвид
гвардия: гвардия
ежегодный: ежегодную
автограф: автографом
неавторитетный: неавторитетными
курьер: курьер
программист: программист
выявление: выявлению выявления
знание: знаний
якут: якутом якут
осуществиться: осуществилась
вакцина: вакцин
пассажир: пассажиры
облисполком: облисполкома
тюмень: тюмень
зарубежье: зарубежья
мартин: мартина мартин
формирование: формированию формирования формированием
неоднократно: неоднократно
исчезновение: исчезновения
председательствовать: председательствовать
напасть: напали
экземпляр: экземпляров экземплярах
нац: нац
предоставляться: предоставлялись
земцов: земцов
компьютерный: компьютерная
возрасти: возросло
код: кода
встать: встал
сегодня: сегодня
отражать: отражать
переводиться: переводились переводился
африканистика: африканистика
группировка: группировок
рот: рта
абрахамса: абрахамса
утвердить: утверждена утвержден утверждено
ард: ард
мнение: мнению мнении
порог: пороге
поныне: поныне
нумизматичня: нумизматични
популяционный: популяционно
родович: родовичами
сохранить: сохранить
очевидец: очевидец очевидцем
формировать: формируют
развернуться: развернулась
мадийя: мадийя
богородск: богородске
изобретать: изобретать
кудряшов: кудряшов
энергетика: энергетики
толк: толка
пцф: пцф
династия: династия династией
периодичный: периодична
лжепророк: лжепророки
свет: свете света
поезд: поездов
учёба: учеб учебу
магия: магия
микрометрический: микрометрическими
дошкольный: дошкольного
абуталиб: абуталиб
точный: точная
самосознание: самосознании
расчленение: расчленении
целый: целых
условие: условиями условию условий условие условиях
разрабатывать: разрабатывали разрабатывал разрабатывает разрабатывать
махма: махму
финальный: финальную
исполнять: исполнял
бакалаврский: бакалаврскими
бацилизин: бацилизина
полезный: полезную полезных полезными
проводить: проводит проводя проводят
органический: органическая
лейтенант: лейтенант
дивизион: дивизиона
ветэрынарный: ветэрынарная
христос: христа
бывать: бывал
среднее: среднем
упрощение: упрощению
ногинск: ногинске
кен: кен
вкп: вкп
гитара: гитару
имам: имам
кран: крана
обусловленность: обусловленностью
молекулярный: молекулярно
сдать: сдать сдал
риор: риор
поведенческий: поведенческую поведенческая
брокгауз: брокгауза брокгауз
википедия: википедия
редакторский: редакторская
марат: маратом марат
обком: обкома
посвящать: посвящает
абрамешина: абрамешин
редактор: редактор редактором
появиться: появились появился
застройка: застройки
исхак: исхак
нора: нор
рдз: рдза
свободный: свободную свободная
выполнение: выполнением выполнения выполнении выполнению
михнаф: михнаф михнафу
автобиография: автобиография
суперкомпьютер: суперкомпьютеров
халдун: халдун
отстранение: отстранением
оскол: оскола осколе
инициатива: инициативой инициативе инициатива
муджахид: муджахид
учебник: учебников учебника учебнике учебник учебником
федорец: федорец
манускрипт: манускрипте
параметр: параметрах параметрами параметров
наземный: наземно
харбинский: харбинская
эпос: эпосу
администрация: администрация
изучаться: изучались изучаются
харбин: харбине
абихта: абихт абихта
дважды: дважды
шестидесятилетие: шестидесятилетию
уо: уо
готовиться: готовился готовиться
сахар: сахаром сахара
корсунуть: корсунь
самсонович: самсонович
координационный: координационная
уважение: уважением
экстерн: экстерном
конкурс: конкурсе конкурса конкурсу конкурсов
джалалуддин: джалалуддин
совладелец: совладельцем
ва: ва
тайно: тайно
иностранный: иностранных
белорус: белорусов белорусы
психиатр: психиатры психиатр
делегация: делегаций
торгпредство: торгпредстве
челябинский: челябинскую челябинская
совр: совр
сарьян: сарьяном
университетский: университетская
интуиция: интуиция
семинария: семинария
поведение: поведения
астрология: астрология астрологию
категория: категорий категория
гомель: гомеле
пара: пар пару
верхний: верхнем верхняя верхне
бремен: бремене
цилиндр: цилиндра
переписываться: переписывался
подвергаться: подвергался
эндокринология: эндокринология
формироваться: формировалась
возможность: возможностью
отправка: отправки
оригинальный: оригинальную
недоступный: недоступная
слон: слон
забрать: забрал
вариация: вариация
целое: целом
бротз: бротзу
герберт: герберт
отрасль: отраслью отраслей отраслях
байконур: байконур байконура
захирийя: захирийя
резерв: резерва
приехать: приехавшая приехал
элементарный: элементарная элементарных
лингвистика: лингвистики лингвистика
гродненский: гродненская
решаться: решается решались
день: дню дней дням дня
мухтар: мухтар
физматгиз: физматгиз
стажировка: стажировку
приведение: приведению
океан: океане
нарушать: нарушает нарушать
энциклопедия: энциклопедий энциклопедия
атанас: атанас
светильник: светильника
рубен: рубен
возникновение: возникновения
пена: пенах
кук: куки
аммоний: аммония
помещаться: помещались помещался
вольноотпущенник: вольноотпущенник
вал: валами
иви: иви
внедрение: внедрения внедрению
психоаналитик: психоаналитики психоаналитик
коминтерн: коминтерна
прозаик: прозаик
нацистский: нацистская
ния: ния
игумен: игумене
потерять: потерял
коэффициент: коэффициентами
лёд: льды льда
суфий: суфиях
хурра: хурра
менеджмент: менеджмента
затмение: затмений
микрокапля: микрокаплях
магазин: магазина магазине магазинов
синтез: синтеза
арутюн: арутюн
питта: питта
таджикский: таджикская
ариэль: ариэль
управлять: управлять
различие: различии
самаркандский: самаркандская
прекрасный: прекраснее
спросить: спросили
люгат: люгат
балет: балета балете
большевик: большевикам
жених: женихом
венгрия: венгрия венгрию
элеватор: элеваторов
морить: мори
пятиугольник: пятиугольника пятиугольнике
съесть: съел
игорь: игорю игорь
получаться: получается
айриян: айриян
соискание: соискание
дубровин: дубровин
биномиальный: биномиальная
глубоко: глубоко
фондообразователь: фондообразователи
рхта: рхту
пептид: пептидов пептида
перемешивание: перемешиванию
продемонстрировать: продемонстрировал
картография: картография
закавказье: закавказья
командор: командоры
осмотр: осмотра
иаэ: иаэ
включение: включений
род: родом рода
принц: принц принца
кандагар: кандагара
кдц: кдц
гоголь: гоголе гоголь
достаток: достатком
предприниматель: предпринимателей предпринимателя
отличить: отличить
колумбия: колумбия
продвинуть: продвинул
таснийя: таснийя
часть: частью частей частях
предостерегать: предостерегает
политехник: политехники
штрекмейстер: штрекмейстер
куриный: курин
ставить: ставит
тур: тура
кристаллографически: кристаллографически
обращение: обращения обращениями
зона: зону зоне зон зонах
узбекский: узбекская
гуманистика: гуманистика
микросхема: микросхем
отзываться: отзывался
публицистика: публицистика
кожа: кожи
рабфак: рабфаке
румыния: румыния
дорога: дорогу дорог дорога
пласт: пласте пластов пластах
сергей: сергей
адаптация: адаптация
истребление: истреблении
пожениться: поженились
труба: трубу труба труб
доступ: доступа
конный: конно
элоиза: элоиза
алгоритм: алгоритм алгоритмов
урология: урология
подборка: подборка
парашют: парашюте
сыграть: сыграла сыграл
терапевт: терапевт терапевты терапевтом
любитель: любителей любитель
локализация: локализация
соавторство: соавторстве
рекомендация: рекомендациями рекомендаций
чиж: чиж
ректор: ректоры ректором ректор
даул: даула
самойлович: самойлович
цирк: цирка
налоговый: налоговых
маяк: маяка
грин: грина
вскрытие: вскрытием вскрытий
эндемик: эндемик
пустой: пуст
азд: азд
кинематография: кинематографий
единственно: единственно
айй: аййам
гнс: гнс
азия: азия
видеозапись: видеозаписями
признание: признания признанию
станислав: станислав
турбеллярия: турбеллярий
усвоение: усвоении
иммунитет: иммунитета иммунитетом иммунитетах
привилегия: привилегиях
кафан: кафанов
ргб: ргб
юбилейный: юбилейная
возвратиться: возвратился
меньшинство: меньшинств
вайс: вайс
востоковед: востоковед востоковеды
санжар: санжар
наместничество: наместничестве
арабист: арабистами
экзамен: экзаменов
меценат: меценат
шилка: шилки
стол: столу столе столом
родный: родном
виноватый: виноваты
марк: марк
самуэль: самуэлем
комдив: комдивы
любой: любого
предварительный: предварительного
илиодор: илиодоре
приводить: приводят приводит
близкий: ближайшие
башкирия: башкирию
грабёж: грабеже
академкнига: академкнига
академический: академическую академическая
гатчина: гатчина
евгениевич: евгеньевич евгеньевна
муаннас: муаннас
леонтиевич: леонтьевна
туркменистан: туркменистана
стоянка: стоянка
недоразвитый: недоразвитыми
клад: кладов клада
пуск: пуска
кратко: кратко
электродинамика: электродинамика электродинамике электродинамикой
валентин: валентин
приносить: приноси
сияние: сиянии
бруннермайер: бруннермайером
театр: театра
потребительский: потребительских
низ: низам
методологический: методологические
уйти: ушла ушел
поддержать: поддержал
эст: эст
замуж: замуж
источник: источникам источником источника источников источниках источниками
полгода: полугода
знаток: знатоком
рояль: роялем
узакбай: узакбай
аран: аран
архитектурный: архитектурно
дэвид: дэвидом дэвида дэвид
фторид: фторидов
тилюгон: тилюгоном
гоу: гоу
халл: халлам
мишустин: мишустин
ницэвт: ницэвт
юрий: юрия юрий
палеонтология: палеонтология
истратить: истратив
искусство: искусством искусства искусству искусств искусстве
цель: целью целях целей
предоставить: предоставил предоставлено
нуклон: нуклонов
массоперенос: массопереноса
останавливаться: останавливается
зес: зес
обществознание: обществознанию
чка: чка
мухаддис: мухаддисом
точ: точ
проверка: проверке проверка проверки
янус: янус
оралбаевич: оралбаевич
новослободский: новослободская
заслужить: заслуженная
мозырь: мозыре
ггц: ггц
садовод: садовод
каталанский: каталанская
персональный: персональная персональных
молотов: молотове
доброволец: добровольцем
абла: абла
последователь: последователь последователи
ама: ама
абельсон: абельсона
цитата: цитату цитатам
феррит: феррита
лукас: лукас
абовиан: абовиан
власть: властью властей
термез: термезе
командировка: командировку
геология: геологию геология
мотив: мотивами мотивам
мичиган: мичиган
гидрофильный: гидрофильную
лингвист: лингвист лингвисты
замужество: замужестве
дисконтирование: дисконтированием
хорватский: хорватская
труп: трупов
брамич: брамич
сафиха: сафиха
вки: вки
византия: византия
надмогильный: надмогильная
абросимов: абросимове
киев: киеве
облегчить: облегчить
миграция: миграция
расчёт: расчетов
андреев: андреев
амилоидоз: амилоидоза
самуил: самуилом самуил
сепаратистский: сепаратистскими
делать: делать делает делают
ивт: ивт
устроить: устроил устроила
многое: многом
фредгольм: фредгольма
губерния: губерния губерний губерниях
абибулла: абибулла
находиться: находящихся находится
старший: старшая
беспорочный: беспорочную
август: августа августе
эстет: эстетом
построение: построению построения построении
аббат: аббата
теплопроводность: теплопроводностью
сгма: сгму
недостаток: недостатков
микробиология: микробиология
пионер: пионер пионером
орловский: орловская
училище: училища училищ
выборгский: выборгская
бахий: бахий
лебедев: лебедев лебедевым
третий: третью третья
агфалах: агфалаху
уоллес: уоллес
давидович: давидовна
разведотдел: разведотдела
гасан: гасан
обмен: обмена
ревком: ревкома
выполняться: выполняются выполнялись
филантроп: филантропы
танк: танка
обревизовать: обревизовать
языковед: языковед языковедах
заразиться: заразившись
стихотворение: стихотворений
коррупция: коррупцией
фил: фил
переиздать: переиздана переиздано
адмирал: адмирал
тритикал: тритикале
падуя: падуя падуе
поликан: поликанов
кошкин: кошкин
натуралист: натуралист
обслужить: обслужил
дворянин: дворянах
геогра: геогр
арсений: арсений
успешно: успешно
таиланд: таиланде
спелеологиягеология: спелеологиягеология
лейпциг: лейпциге
оседлый: оседло
холмик: холмиком
заготовка: заготовка
вестись: ведутся
воспитанник: воспитанники воспитанник
нильс: нильс
издавать: издает издавал
говорить: говорил говорит говоря
рай: рая
ергин: ергин
харис: харис
проявиться: проявились
обряд: обряда
джон: джон джоном
рекомендовать: рекомендуемая
амра: амра
бениамин: бениамин
ханс: хансом
шведский: шведская
епиграфски: епиграфски
мас: мас
выигрыш: выигрышем
речной: речную
столб: столба
пекин: пекине
наготове: наготове
тобол: тобола
снизиться: снизилась
прецессия: прецессию
станиславский: станиславского
вильям: вильям
кандидатура: кандидатуру
научный: научный научными научная научную
облучение: облучении
энеолит: энеолита
новик: новик
циолковский: циолковский
подготавливать: подготавливает
совместительство: совместительству
абдурахманович: абдурахманович
хайдарабад: хайдарабаде
хабибуллаев: хабибуллаев
чурилов: чурилов
канадский: канадский канадских канадская
конструкция: конструкциями конструкций
устойчивый: устойчивых
унтер: унтер
гончаров: гончарове
престарелый: престарелых
термохимия: термохимия
край: края крае
телемеханика: телемеханика
холокост: холокоста
алишер: алишер
лазаревич: лазаревна
мт: мт
вторичный: вторичная
дополняться: дополняются
диссовет: диссовете
тифлис: тифлисе
мощный: мощными
уфимский: уфимская
энеолитический: энеолитическая
дойти: дошло
руфат: руфат
сопровождение: сопровождении
использовать: используя используемую использует
фон: фоне
безупречный: безупречную
владение: владениях
посещение: посещением посещения
этика: этика
захарясевич: захарясевич
заболотный: заболотный
охапкин: охапкин
дерево: деревьев
макс: макс
хранить: хранит
сармат: сарматы
мазхаб: мазхаб
ареал: ареалов
жигулин: жигулине
тарас: тарас
кал: кала
широколиственный: широколиственно
этос: этосе
извержение: извержением извержений
наименее: наименее
вероятность: вероятностей
прерваться: прервался
совхоз: совхозом
музаффар: музаффар
финансово: финансово
чрезвычайный: чрезвычайного
аминогруппа: аминогрупп
победить: победил
ряд: ряда ряде рядов рядах
авамиль: авамиль
платёж: платежа
климатически: климатически
свободно: свободно
консорция: консорция
спецоперация: спецопераций
харьков: харькове
енисей: енисея
трудоустройство: трудоустройстве
иврит: иврите
доллар: долларов
избирательный: избирательных
ямал: ямалов
телефильм: телефильма телефильмов
докторский: докторскую докторская
левицкий: левицкий
мирзаметович: мирзаметович
сотня: сотен
ринц: ринц
ние: ние
невключение: невключения
махмуд: махмуд
санитарный: санитарно
манера: манеру
диаметр: диаметра
путь: путей путях
солнце: солнца
объяснять: объясняет объяснять
кинематограф: кинематографу кинематографе кинематографа
литургия: литургией
минералогический: минералогическая
застать: застал
гель: геля
портрет: портретов
предложение: предложению предложении предложениях
хозяйство: хозяйстве хозяйства хозяйством
обозначение: обозначения обозначением
франс: франс
учреждение: учреждений учреждении
выслуга: выслугу
дгу: дгу
способ: способом
атомный: атомная атомно
чит: чит
матч: матче матчей
машиностроение: машиностроению
слушать: слушал
рисунок: рисунков рисунками
иной: иными
заджжадж: заджжадж
фе: фе
земля: землях земли земля
франтить: франти
сярг: сярге
егиш: егише
далёкий: дальше
подкомитет: подкомитета
лариса: лариса
карачев: карачеве
появляться: появлялась
зангезура: зангезур
химик: химик химики
ино: ино
мз: мз
обосновать: обосновал
георг: георг
газовый: газовая газовых
латвия: латвия латвию
нева: неве
какимбек: какимбек
почтовый: почтовая
шириться: ширится
проктор: проктором
худойкулович: худойкулович
отъезд: отъезду отъездом отъезда
барий: бария
либерализм: либерализма
тахир: тахиром
содействовать: содействовал
шам: шам
орсить: орси
общество: общества обществ обществу обществе
археологический: археологическая археологическими
зам: зам
общественник: общественниками
кривошеев: кривошеев
амортизатор: амортизаторов
секция: секция секций
метавычисление: метавычислений
куб: кубов
расчленять: расчленял
музахим: музахим
паралич: паралича
минас: минас
пилюгин: пилюгин
шафиит: шафииты
километр: километров километрах
попасть: попал попасть попало
сайт: сайта сайте
история: историю историей история
мобильный: мобильная
миан: миан
рахман: рахман
северокавказский: северокавказская
оказание: оказания
отложить: отложить
куратор: куратор куратором
лгать: лгут
формула: формула формулу формул
электроэнергия: электроэнергии
тридцать: тридцати
пленник: пленник
хэтхауна: хэтхаун
яд: ядов
демократический: демократическую
карий: кари
бохум: бохума
ве: ве
престонпанс: престонпансе
опытный: опытными
кристалл: кристаллов
диффузия: диффузия
назад: назад
чехословакия: чехословакия
постдок: постдоком
вращение: вращения
грибоедов: грибоедове
нектарий: нектария
биотехнолог: биотехнолог
огромный: огромную
нерабочий: нерабочими
кпи: кпи
сириец: сирийцев
чтец: чтецы чтец
нью: нью
рукоположить: рукоположил
сэ: сэ
инфраструктура: инфраструктура
прорыв: прорыва
едва: едва
штаб: штабе штаба штаб
нигерия: нигерия
дас: дас
фундаментальный: фундаментальных
непрерывный: непрерывна
матэматычный: матэматычная
вычислый: вычисл
горизонт: горизонтов
григориевич: григорьевич
икона: иконах
инструмент: инструментов инструменте
командование: командованием
ибрагим: ибрагим
королева: королевы
оборона: обороны оборона оборону
набор: набора
хва: хва
дзидра: дзидрой
химически: химически
казахстанский: казахстанская
ованес: ованес
краевед: краеведы краевед
отобрать: отобран
известие: известий известиях
илья: илья
передвижение: передвижения
адъютант: адъютантом
есай: есаи
достоинство: достоинств достоинствами
аппаратостроение: аппаратостроению
вспять: вспять
эра: эры
фгу: фгу
анапа: анапе
макфаддный: макфадден
ольга: ольга
фау: фау
мекка: мекку мекка мекки
сенатор: сенатор
морфолог: морфолог
реквием: реквиему
заря: заря
знакомиться: знакомится
святитель: святителя
троицк: троицке
сокращать: сокращая
опровергнуть: опровергнута
хна: хну
стратегический: стратегическими
ортопедический: ортопедическая
покров: покрова
младший: младшую
калугин: калугин
жилище: жилищ
шарль: шарль
дьюй: дьюи
договор: договора
кордит: кордита
бег: беге
шк: шк
медведь: медведя
музыковедение: музыковедением
коллекционер: коллекционеры коллекционер
рений: рения
мерриём: мерриема
постоянный: постоянная постоянными
циклический: циклическая
отредактировать: отредактирована отредактировал отредактировать
семантика: семантика
кильпа: кильпа
тематика: тематике тематику
оседать: оседал
репетиторство: репетиторством
речь: речь
истый: ист
интересоваться: интересуясь интересовался
автореф: автореф
неутомимый: неутомимо
ленгер: ленгере
леонтьев: леонтьев
плита: плит
резонанс: резонанса резонанс
размер: размерах
осман: осман
ивлев: ивлев
частность: частности
континент: континентах
травма: травм
альбумазар: альбумазару
узнать: узнал узнав
давыдович: давыдович
фундамент: фундаментов
давний: давнюю
публицист: публицист
формулировка: формулировку
тихонрав: тихонравов
бой: боях
погрешность: погрешностей
мельник: мельник
антропоцентризм: антропоцентризмом
филипп: филиппа филипп
факт: факта фактов
кассиодор: кассиодора
джакконь: джаккони
снимать: снимал снимайте
везувий: везувия
абсолютно: абсолютно
секунд: секундов
фид: фида
анатоль: анатоль анатолю
флот: флота
юнона: юнона
вывести: вывел
таш: таш
лишиться: лишился
иа: иа
авторитет: авторитетом
насаф: насафе
провинция: провинция
прежний: прежнего
кузнецкстрой: кузнецкстроя
просить: просил
азатович: азатович
раствор: растворов растворах
груз: груза
кул: кул
джафар: джафар
георгий: георгий
гасанагаевич: гасанагаевич
они: ими ними
екатеринбург: екатеринбурге
олива: олива
бавария: бавария
желтиков: желтиков
заключаться: заключались
осип: осипом
осложнение: осложнений
мемориал: мемориале
химкомбинат: химкомбината
привезти: привезено
вардан: вардан
ограничение: ограничениях
равный: равна
долгота: долгот
игп: игп
садриевич: садриевич
бета: бета
эдвин: эдвином
никель: никеля
танах: танаха
эллипсоид: эллипсоидах
кикоина: кикоин
разговаривать: разговаривает
циклоп: циклопах
нахождение: нахождения
акопджан: акопджану
миметический: миметическая
усилие: усилий усилиями
определяться: определяется
микротеплообменник: микротеплообменникам
говард: говард
заполнить: заполнить
колебание: колебаниями колебаний
прогресс: прогресс прогресса
высчитывать: высчитывать
намыслуть: намыслув
завещание: завещанию
рим: рима риме
ивантеевка: ивантеевки
мгоп: мгопу
моральный: морального
проверяться: проверялась
гидронефроз: гидронефрозов
предъявлять: предъявляемыми
странник: страннике
разрушить: разрушены разрушена разрушен
вирус: вирусов
бейрут: бейрута бейруте
смысловой: смысловая
заметный: заметными
альфа: альфа
зигмунт: зигмунт
распространить: распространил
умение: умении
крюков: крюков
бронетехника: бронетехники
позвоночник: позвоночника
адр: адр
судрабкална: судрабкална
согласиться: согласиться
розенберг: розенбергом
евгений: евгений
гугушивить: гугушивили
командовать: командовал
святой: святых
нерезонансный: нерезонансными
ростовский: ростовская
рмэ: рмэ
ожидание: ожиданий
рг: рг
минерал: минералов
трудный: трудными
обращаться: обращался
силезия: силезия
косиб: косиба
прерывать: прерывал
приморский: приморская
отразить: отразили отражено
подпись: подписью
рап: рап
разъясняться: разъясняются
казах: казах
внутренний: внутреннюю внутренних
ру: ру
стокгольмский: стокгольмская
землетрясение: землетрясение
бгу: бгу
матёрый: матер
располагаться: располагалась
гормон: гормонов
особый: особыми особая
диссертант: диссертантом
балхаш: балхаше
софист: софистом
рассол: рассолов
тихо: тихо
маик: маик
достаточно: достаточно
предпатент: предпатентов
вафа: вафой
подобный: подобными подобную
касаткин: касаткин
альма: альма
отвага: отвагу
перспектива: перспектив
ю: ю
художница: художница
недавний: недавнюю
гобхауза: гобхауза
аристотелизм: аристотелизма
гигантский: гигантскую
фридрих: фридрихом фридриха
нпи: нпи
белок: белков
комплект: комплекта
высылаться: высылался
иванов: иванов
гигиена: гигиены
директораинститут: директораинститута
германист: германист
саксония: саксония
вариант: вариантов
пророк: пророка пророков
адрес: адресу
вулкан: вулкан вулкана
отпор: отпор
казаться: казаться
односторонний: односторонняя
заполнять: заполнять
обзор: обзора
трудно: трудно
всемирный: всемирную
альфонс: альфонсом
егу: егу
передерий: передерий
инженерный: инженерно
лы: лы
возглавить: возглавила возглавил возглавить
героический: героическая
кларендон: кларендона
уткин: уткин
стокгольм: стокгольме
ефимович: ефимович
издатель: издатель издатели
прочность: прочность
корпорация: корпорация
жаднов: жаднов
чувство: чувств
воспроизведение: воспроизведением
акакий: акакий
лазарь: лазарь
ахбар: ахбар
зарабатывать: зарабатывает
поджелудочный: поджелудочной
апарин: апарин
формализм: формализму
ной: ной
исполком: исполкома
ангел: ангелы ангелом
кольридж: кольриджа
неразработанный: неразработанную
записать: записан
разный: разным
изобразить: изображены
техносферный: техносферная
свежий: свежие
довести: доведя
мутафаррик: мутафаррика
местный: местного местных
пережить: пережили пережил
прослеживаться: прослеживается
лично: лично
уроженец: уроженец
активно: активно
уч: уч
остеохондроз: остеохондрозом
досуг: досуге
историографический: историографическую
познание: познанию
лонгша: лонгшам
инновационный: инновационную
воздух: воздуха
муниципальный: муниципального
поехать: поехал
человечество: человечеству
либеральный: либеральная
существенно: существенно
дизайн: дизайну дизайном дизайна
палеобиолог: палеобиологом
кобленц: кобленце
зоолог: зоологи зоолог
ручка: ручками
предстать: предстал
долг: долга
корреляция: корреляций
впоследствии: впоследствии
архивный: архивная
естественный: естественную
вскоре: вскоре
кобальт: кобальта
пеппердин: пеппердин
эпр: эпр
страдать: страдают страдал
куросава: куросава
кларнет: кларнете
воображение: воображения
значительно: значительно
предисл: предисл
тобольск: тобольске
фиц: фиц
джаз: джаза
тус: тус
ярославский: ярославская
абт: абту абт
казнит: казниту
иуда: иуда
авторский: авторских авторского
вмк: вмк
облик: облику
террор: террора
хамить: хами
богуслав: богуславом
кузина: кузина
иллюзия: иллюзий
автоматика: автоматика
никита: никиты
армстронг: армстронг
зинаида: зинаида
комиссариат: комиссариате
противокаракуртовый: противокаракуртовая
опд: опд
аэрогазодинамика: аэрогазодинамики
уничтожить: уничтожены
эффективность: эффективностью
отправление: отправлений
ц: ц
стресс: стресса
ашхарабарист: ашхарабарист
спокойный: спокойная
устраиваться: устраивались
продажа: продаж
рамка: рамках
термодинамический: термодинамическая
пересмотр: пересмотру
филиппович: филиппович
обследование: обследовании
держава: держава
доминирование: доминирования
живопись: живопись
ступень: ступеней
дискуссия: дискуссий
латинский: латинском латинскими
измерить: измерен
переименование: переименований
реабилитация: реабилитация
география: географию география
организационный: организационная организационную
сейфуллин: сейфуллин
изучий: изуч
геомагнетизм: геомагнетизма
лактамный: лактамную
критика: критику
преодолеть: преодолел
кустарник: кустарника
генштаб: генштаба
приходиться: приходилось приходится
почва: почв
гуманитарный: гуманитарно гуманитарная
панацея: панацеей
примечательно: примечательно
полиграфический: полиграфическая
выехать: выехал
ватикан: ватиканом
реман: реман
народжан: народжаны
умирзакович: умирзаковна
африканский: африканская
этнография: этнографией этнография этнографию
тамара: тамара тамарой
изложить: изложены изложил
кораблестроитель: кораблестроители
националист: националистов националист
ждать: ждал
лаптев: лаптев
влюбиться: влюбился
существо: существу
последствие: последствиях последствиями
долло: долло
крымский: крымская
храм: храмов
политик: политик
лесной: лесном лесная
тулуза: тулуза тулузы
эиу: эиу
молдова: молдовы
аудиенция: аудиенцию
варий: вариях
переулок: переулке
посредничество: посредничестве
плодотворный: плодотворную
губернский: губернская
продовольствие: продовольствия
аудитория: аудиторий
совместный: совместная
пропасть: пропал
хадж: хаджа
шаповал: шаповал
незадолго: незадолго
шарлотсвилла: шарлотсвилл
витебск: витебске
сопровождаться: сопровождается сопровождаться
мухин: мухин
мельница: мельница
беларусь: беларусь
заглянуть: заглянуть
пробудиться: пробудись
отчаянный: отчаянная
ренессанс: ренессанса
информатизация: информатизация
рубеж: рубежом рубеже
магомедмирза: магомедмирза
агрессия: агрессия
ингибирование: ингибированию
раскладывать: раскладывал
понедельник: понедельникам
измениться: изменилось
царизм: царизма
прятать: прячет
худуда: худуд
отбор: отбора
субъективный: субъективная
индия: индию индией индия
абрикосовый: абрикосова абрикосовы
последовательно: последовательно
петруся: петруся
йахй: йахйа
кристофер: кристофер
прекурсор: прекурсоров
столоначальник: столоначальником
исключение: исключением
пироксилин: пироксилина
постоянно: постоянно
горком: горкома
ввц: ввц
арчибальд: арчибальдом
афанасьев: афанасьев
триглицерид: триглицеридов
интересный: интересен
выходить: выходит
покоритель: покоритель
лыжа: лыжах лыжами
пьер: пьер
психиатрия: психиатрия
смена: смен
зрение: зрения
инфекция: инфекций
въезд: въезд
койка: коек
сесть: сел
обратно: обратно
марголиус: марголиусом
авторство: авторства
уступка: уступками
крестоносец: крестоносцами
мая: маи
шверблюм: шверблюма
весна: весны весна
рифат: рифат
воеводство: воеводств
готовить: готовил
словцов: словцове
проставить: проставив проставить
мвт: мвту
отрицатель: отрицатели
полимеризация: полимеризацию
распространение: распространения
гульнара: гульнара
консул: консул консулы
наркомпрос: наркомпросу наркомпросе
гидрогеолог: гидрогеологом
озеро: озера
скитание: скитаний
са: са
упоминать: упоминает
зерносовхоз: зерносовхозе зерносовхоза
переиздание: переизданий
вслепую: вслепую
технолог: технолог
багаев: багаев
попросить: попросили
ноябрь: ноября ноябре
план: планом
эмульсия: эмульсий эмульсиях
радиосигнал: радиосигнала
археометрия: археометрия
решетов: решетов
мгс: мгсу
номад: номад
участница: участница
испытатель: испытатели
предложить: предложены предложил
костюм: костюме
разряд: разряду разрядом
уменьшать: уменьшает
долгий: долгую долгое
ду: ду
хельмштедт: хельмштедте
сформироваться: сформировался
выглядеть: выглядит
бугенвиль: бугенвиле
амер: амер
прогрессивный: прогрессивную
наум: наум
установка: установок установка
прослушать: прослушал
элиста: элиста
феникс: феникс
блюминг: блюмингом
белеть: белев
артиллерия: артиллерия
аршалуйсович: аршалуйсович
липшица: липшиц
утопист: утопист
инициатор: инициатором инициатор
популяция: популяций
унц: унц
мужской: мужскую
дэн: дэн
закристаллизовать: закристаллизовать
ямб: ямбах
эл: эл
куйбышев: куйбышева
гебраист: гебраисты
абрам: абрам
прогимназия: прогимназию
многократный: многократного
ходатайство: ходатайству
описать: описал описаны описан
рассказывать: рассказывала
скот: скота
гузиз: гузиз
сплит: сплите
беседа: бесед беседу
увековечение: увековечении
абзал: абзал
пыл: пылом
однокурсник: однокурсником
алистер: алистер
гляциоструктура: гляциоструктура
караван: каравана
компаунд: компаундов
кафедральный: кафедральном
болеть: болела
райпищеторг: райпищеторга
тереть: тер
оленеводство: оленеводству
медгиз: медгиз
партнёрство: партнерствах
вручение: вручением
марксизм: марксизма
гидрокрекинг: гидрокрекинга
эстонец: эстонец
экономист: экономисты экономистах экономист экономисте
секстант: секстанте
сидней: сиднеем
мех: мехом
угон: угоне
лечсанупра: лечсанупра
морфология: морфология
налаживать: налаживал
гринбергс: гринбергсом
исполниться: исполнилось
телерадиокомплекс: телерадиокомплекса
зияд: зияд
палеография: палеографию
джабра: джабр
григорович: григорович
интернет: интернете
франкфурт: франкфурте
эдитнотис: эдитнотисом
отд: отд
положение: положении
лфк: лфк
прийтись: пришлось
местечко: местечке
юнус: юнус
алкоголизм: алкоголизма
воплощение: воплощение
неисправный: неисправно
киноактриса: киноактрисой
фанатизм: фанатизме
алтый: алто
синдикат: синдиката
являть: являют
отпуск: отпуск
социалист: социалист
ргия: ргий
диффеоморфизм: диффеоморфизмов
буланин: буланин
собственный: собственную
армянский: армянская
ровесник: ровесники
оксазолоновый: оксазолоновую
операция: операций
ржев: ржеве
окаменелость: окаменелостей
дания: дания
нужный: нужна
филип: филип
томаш: томаш
библиограф: библиографы библиограф
геометрически: геометрически
конструирование: конструирования
вороновский: вороновском
медведев: медведев
мясной: мясная
перечень: перечням
африканист: африканисты
продромус: продромус
рульф: рульф
миллионер: миллионерами
микропроцесс: микропроцессов
познакомить: познакомил
интеллигент: интеллигенты
абрамить: абрамя
воспитать: воспитал
тревога: тревог
чепуха: чепуха
папченков: папченков
преторий: претория
воевать: воевал
флористический: флористическая
казга: казгу
единственный: единственная
материнство: материнства
ход: ходе
перерыв: перерывом
математика: математикой
нижний: нижняя нижнем нижне
ознаменование: ознаменовании
прозвание: прозваний
пенициллин: пенициллина
закрепление: закреплению
антисоветский: антисоветскую
кристиан: кристианом
тонкий: тонкими
городок: городка городке
изначально: изначально
изобразительный: изобразительном
приток: притоков
дерпт: дерпте
съезд: съездов съезде съезда
кинокритик: кинокритик
фольклорист: фольклористы
пединститут: пединститутов пединститута
ерец: ерец
хайят: хайят
татьяна: татьяна
друг: друзья
киевский: киевском
бурение: бурением
одобрение: одобрением
ерохин: ерохин
астролябия: астролябией астролябий
пешеход: пешеход
романтический: романтическая
проектирование: проектированию проектировании проектирования
вмешательство: вмешательств вмешательства
ярус: ярусом
дервиш: дервиш
оплата: оплата оплату
радиоматч: радиоматче
мерзлота: мерзлота
алфавитный: алфавитном
иррегулярный: иррегулярными
прораб: прораб
сердцевина: сердцевина
аджимушкать: аджимушкай
семейный: семейных
правописание: правописанию
картографировать: картографировал
бушуев: бушуев
толкование: толковании
писание: писания
ро: ро
импульс: импульсов импульса
сфу: сфу
именование: именовании
планировка: планировках
кавказовед: кавказоведы кавказовед
нормирование: нормировании
француженка: француженка
литературный: литературная
проспект: проспекте
потомок: потомок
терроризм: терроризма
сталкиваться: сталкивается
упростить: упростить
машинистка: машинисткой
уголовный: уголовному
сказаться: сказалось
наоборот: наоборот
приозерск: приозерске
кузница: кузницей
гомельский: гомельская
соревнование: соревновании соревнований
изотоп: изотопов
прекращение: прекращения
караганда: караганда
сыздык: сыздык
философия: философия философию
картографирование: картографировании
убейд: убейда
этиология: этиология
остановка: остановок
термический: термическая
ежегодно: ежегодно
сакт: сакта
сара: сары
обложка: обложка
мутазилизм: мутазилизму
посредник: посредником
бих: бих
революционер: революционеры революционером
штамм: штаммов
холл: холла
сумма: сумма сумму
электродвигатель: электродвигателей
желание: желанию
стадо: стад
треугольник: треугольника
внезапно: внезапно
импульсаразработать: импульсаразработал
лечкомиссия: лечкомиссию
никакой: никаких
иса: иса
эберхард: эберхардом
райнер: райнер
шафаревич: шафаревич
рэд: рэд
лекарство: лекарств
туркменистанский: туркменистанская
пластина: пластин
библиография: библиография
вносить: вносят
тектоника: тектоника
башг: башгу
элемент: элементов
псевдоним: псевдонимом псевдонимов
напечатать: напечатан напечатал
волго: волго
сельсовет: сельсовета
вновь: вновь
пол: пола
представиться: представились
маркшейдер: маркшейдером
анийй: аниййа
хиш: хишам
пенсильвания: пенсильвания
махек: махек
владислав: владислав
призвать: призван
рудбекский: рудбекская
полимер: полимеров
госплан: госплане
молдавский: молдавская
указывать: указывал указывают
особо: особо
слава: славы слава
дача: даче
рейтц: рейтц
телеведущий: телеведущий
распределение: распределении распределению
мохсный: мохсен
пачатковать: пачатковай
желудок: желудка
здоровый: здоров
миокард: миокарда
максвелл: максвелла
иртыш: иртыша
норма: норм
перенос: переноса
абов: абов
ида: ида
меркаптокислота: меркаптокислоту
оплачивать: оплачиваемую
кантон: кантонов кантона
ирон: ирон
флавий: флавием
дипломный: дипломная дипломную
подчёркивать: подчеркивал
почерк: почерка
обсуждение: обсуждения обсуждением
дром: дром
жидкость: жидкостей
шовкетович: шовкетович
количественный: количественную
семилетка: семилетку
схема: схемах схем
обрабатывать: обрабатывать
излучение: излучений излучения
механика: механика
лечебный: лечебно
сабирьянович: сабирьянович
грыжа: грыж
монтаж: монтажом
вес: веса весом
моцарт: моцарта
слесарь: слесарем
посол: послом
нцз: нцз
пальма: пальм
политработник: политработником
кау: кау
эколог: экологи
водород: водорода
ценный: ценно
защитник: защитниками
траектория: траектория
спец: спец
учение: учению
пад: пад
мемориальный: мемориальная
рок: рока
бэс: бэс
генератор: генераторов
рациональный: рационального
сурен: сурен
журналистский: журналистская
товарищ: товарищ товарищем
флорентиец: флорентийцы
гудрат: гудрат
сняться: снявшись
торг: торга
вовсе: вовсе
чебоксары: чебоксарах чебоксар
платформа: платформа
созерцание: созерцанию
влиять: влияют
абд: абд
экстремизм: экстремизма
синдром: синдрома
юридический: юридическую юридического
фима: фима
эчмиадзин: эчмиадзине эчмиадзина
заслуга: заслуг заслуга
десяток: десятков
рубль: рублей
практик: практиком
имитационный: имитационная
психолингвистика: психолингвистика
пористость: пористостью
дочь: дочерью
нанотрубка: нанотрубок
сказать: сказал сказать
атрофия: атрофия
оппозиционный: оппозиционную
производственный: производственных
антарктида: антарктиде
габдулахатович: габдулахатовна
прадед: прадед
нелинейный: нелинейными нелинейная
тюбинген: тюбингена
воин: воином
заказник: заказников
комсомол: комсомола
простатит: простатите
завершиться: завершилось завершилась
разлив: разливов
релятивистский: релятивистская
алгол: алголе
сталин: сталиным
сталинский: сталинская
нищета: нищеты
завершать: завершали
туберкулёз: туберкулеза
топливо: топлива
спасать: спасал
днепропетровский: днепропетровскую днепропетровская
будущее: будущем
исправительный: исправительно
заседание: заседаниях заседании
комментировать: комментируя комментирует
аракелович: аракелович
экология: экология
переиздаваться: переиздававшаяся
ленин: ленин
бассейн: бассейна
взятие: взятии
точность: точность точностью
политотдел: политотдела
наказание: наказания
арабски: арабски
некрополь: некрополю некрополе
спектроскопия: спектроскопия
вперёд: вперед
интоксикация: интоксикация
обсерватор: обсерватора
зонненшайн: зонненшайне
фельдшер: фельдшером
донос: доносу
смбатович: смбатович
огонь: огне
нашать: нашай
неверный: неверна
азимут: азимуте
мем: мемом
юзовка: юзовки
аболин: аболин
пятно: пятнах
виртуальный: виртуальная
безотходный: безотходная
ашхарабар: ашхарабар
хина: хина
судан: судане
довольно: довольно
адам: адама
неизв: неизв
магнит: магнитов
быстро: быстро
палеорусло: палеоруслу
изделие: изделий
хикинботтом: хикинботтома
частота: частоты
накладывать: накладывая
неньютоновский: неньютоновскими
проиндексировать: проиндексировано
экологически: экологически
ратный: ратную
сформировать: сформированы
бобруйск: бобруйске
эдгар: эдгар
полоцк: полоцке
елена: елена
товма: товма
украинский: украинская
символика: символику
отход: отходов
лера: лерой
вячеслав: вячеслав
довоенный: довоенная
членкор: членкор
арсентьев: арсентьев
задержаться: задержаться
сразу: сразу
туризм: туризма
графически: графически
специальность: специальностям специальностей
делегат: делегат
гомера: гомера
образец: образцов
направлять: направляет
нефть: нефти
восточносибирский: восточносибирская
произносить: произносят
геоцепочка: геоцепочками
всеобщий: всеобщая
картолитография: картолитография
концептуал: концептуал
зигмунд: зигмундом зигмунд
повествовать: повествовал
электричество: электричества
схоластика: схоластикой
номенклатура: номенклатуру
оперный: оперную
мавераннахра: мавераннахра
мустафина: мустафина
унр: унр
почёт: почета
наиболее: наиболее
рассказываться: рассказывается
бактериология: бактериология
абильдгаард: абильдгаард
мутазилитский: мутазилитская
отнестись: отнесся
палеограф: палеограф
оглядываться: оглядываюсь
альтернативный: альтернативная
последовать: последовало последовали
лугат: лугат
общеобразовательный: общеобразовательную
асм: асм
диплом: диплом дипломом дипломе
мета: мет
аягуз: аягуза
коммуникация: коммуникаций
пертинакс: пертинакса
шпионаж: шпионажа
католикос: католикос
хэмпшир: хэмпшир
подписание: подписания
масахиф: масахиф
персидский: персидском
аэромеханика: аэромеханика
питание: питания
потенциал: потенциала
джаббар: джаббар
синология: синология
би: би
эдуардович: эдуардовна
политехнический: политехническая
магомедович: магомедович
акушерка: акушеркой
вскрываться: вскрывается
полиакриламид: полиакриламида
обезвреживание: обезвреживанию
патриот: патриот
пожар: пожарах
смирнов: смирнов
сельджукид: сельджукидов
голос: голосов
чемпионат: чемпионатах
товмас: товмас
инородец: инородцев
автомат: автоматами
русин: русин
пакет: пакетами
святогор: святогор
семиречье: семиречья
чарльз: чарльз
комплексный: комплексными
диететика: диететика
столетие: столетия
подробно: подробно
гру: гру
захватить: захватили
флоренция: флоренцию флоренция
становление: становлении
радзишевский: радзишевский
алкилфенол: алкилфенолами
лиризм: лиризма
подводиться: подводятся
пирамида: пирамида
виргиния: виргиния
конечный: конечными
красноярский: красноярская
легальный: легальными
сексуальный: сексуальными
меховщик: меховщик
шарап: шарапа
нэп: нэпа
смесь: смесях
ординационный: ординационно
бад: бад
лексингтон: лексингтоне
причисляться: причисляется
слуга: слуга
мышьяковый: мышьяково
восторжествовать: восторжествовал
французски: французски
фосфат: фосфатов
комаровка: комаровки
соломонович: соломонович
дядя: дядя
моз: моз
продукт: продуктов
выиграть: выиграл
митрополит: митрополит
мхитар: мхитар
синтаксономия: синтаксономия
джей: джеем
григорьев: григорьев
бойло: бойл
чувашский: чувашская
требование: требованиями
фаня: фаня
ссыльный: ссыльно
ленсовет: ленсовета
таскаться: таскается
размагничивание: размагничиванием
обычно: обычно
черноморский: черноморская
питтсбург: питтсбурге
биологически: биологически
росмедтехнология: росмедтехнологий
предположение: предположению
десять: десяти
счастливый: счастливую
сотрудничать: сотрудничал
клара: клара
плутоний: плутония
александрия: александрия
исаакович: исаакович
яуналуксненский: яуналуксненская
общий: общем общего общая
заглавие: заглавием
верещатник: верещатники
виноградов: виноградов
восстановиться: восстановился
йорк: йорке
ласик: ласик
благословение: благословение
зав: зав
преддипломный: преддипломную
эксплуатация: эксплуатацию
кора: кору
взаимоотношение: взаимоотношений
устроиться: устроился
хан: хан
уметь: уметь
космос: космосу
кыргыз: кыргыз
саудовский: саудовская
микстница: микстница
блеск: блеска
связаться: свяжитесь
ферросиликоалюминий: ферросиликоалюминия
залежь: залежей
мпг: мпгу
совпадение: совпадению
правоведение: правоведению
референт: референт
подарить: подарил
уллугатагский: уллугатагскую
вос: вос
шампейн: шампейне
календарь: календаре
карл: карлом
лиссабон: лиссабоне
империя: империей империя
дмитровск: дмитровске
ги: ги
француз: французами
забываться: забываются
прикомандировать: прикомандирован
произойти: произошло
прозрачный: прозрачную
аудиозапись: аудиозаписей
поляна: поляна
отступать: отступает
видение: видений
плохой: плохого
хулатаевич: хулатаевич
обогащение: обогащением
диапазон: диапазоне
мученик: мученике
гюльденштедт: гюльденштедтом
губа: губ
ло: ло
сноска: сносок
склоняться: склонялся
ожидать: ожидает
невозможно: невозможно
уехать: уехал
мамка: мамку
удобрение: удобрений
королевство: королевстве
отсталость: отсталостью
оберхаузен: оберхаузене
стойка: стоек
малов: малов
аветик: аветик
глушков: глушков
предыстория: предыстория
великан: великан
дисульфид: дисульфида
очередь: очередь
реологический: реологическими
замужем: замужем
примкнуть: примкнул
белэн: белэн
тираж: тиражом
эльбрус: эльбрусом
митхта: митхт
барацьба: барацьба
вагнер: вагнер
викентиевич: викентьевич
уделять: уделяя уделял
улаживание: улаживания
энерготехника: энерготехнику
звучать: звучало
лагерь: лагерей
ограничивать: ограничивать
ранение: ранениях
саватеев: саватеев
разнообразный: разнообразна
сохраняться: сохраняться
литературоведение: литературоведению
петь: пела
переливание: переливании
подзорный: подзорную
любицкий: любицкая
ареять: ареян
ютз: ютз
что: чему
германистика: германистика
сиднейский: сиднейская
двойной: двойная
партитура: партитур
зб: зб
гармония: гармонию
хронический: хроническими
сахалинский: сахалинская
црм: црм
этнографически: этнографически
иисус: иисуса
пропагандист: пропагандист
неокантианство: неокантианстве
кочевой: кочевыми
сверхпроводник: сверхпроводников
планово: планово
пантеон: пантеоне
одиннадцатилетний: одиннадцатилетнюю
дмитрий: дмитрий
мишень: мишеней
затрагивать: затрагивающую
искусствовед: искусствоведом
заметить: заметили
фунт: фунтов
тета: тета
виос: виос
доц: доц
ломоносов: ломоносов
артурович: артурович
зад: заде
вьетнам: вьетнама
отнять: отнял
примечание: примечания
профессиональный: профессиональная
рассеяние: рассеяния
интенсификация: интенсификация
маймонида: маймонида
рассказ: рассказов
гамильтониан: гамильтониана
дм: дм
брянск: брянске
анатом: анатомы
типография: типография
вьетнамка: вьетнамка
работница: работница
альберт: альберт
абрагамович: абрагамович
игнорировать: игнорировать
сечение: сечений
металлургия: металлургия
купить: куплена
халиль: халиль
крымскотатарский: крымскотатарскую
раввин: раввины
гии: гии
продукция: продукции
восприниматься: восприниматься
плечо: плечах
подпольный: подпольную
вместе: вместе
яблоновська: яблоновська
логика: логика
датский: датская
сравнивать: сравнивают
терапия: терапия
денис: денис
фольклористика: фольклористика
рентгенодиагностика: рентгенодиагностика
весьма: весьма
маша: маша
гау: гау
канпур: канпуре
уния: уния
этап: этапах этапе
заславский: заславский
радиохимия: радиохимия
увлечь: увлечен
вагаршапат: вагаршапате
частично: частично
соискатель: соискателю
списать: списал
кадр: кадров
росспэн: росспэн
фвк: фвк
сковородить: сковороди
фауна: фауну
виталиевич: витальевич
высылка: высылку
имперский: имперскую
воедино: воедино
естествоиспытатель: естествоиспытатель
ниимр: ниимр
выясниться: выяснилось
конкуренция: конкуренция
прасоловый: прасолова
раскрывать: раскрывает
деть: дет
плотность: плотностью
лпд: лпд
научить: научить
везде: везде
картотека: картотека
скржинский: скржинская
почвенный: почвенно
комба: комб
нана: нана
продавать: продаваемую
полководец: полководец
упр: упр
вулф: вулф
асад: асад
выучить: выучил
куинза: куинз
останки: останков
эдвард: эдвард
абрах: абраха
рудник: рудников
стена: стеной стенах
пенициллаз: пенициллазы
предельный: предельная
пахтусов: пахтусов
амхерст: амхерсте
сулейменов: сулейменов
регистр: регистрах
маделунг: маделунгом
республиканский: республиканского
абдуллаев: абдуллаев
гту: гту
полупроводник: полупроводниках
куренцов: куренцов
омар: омар
дик: дик
электрофизика: электрофизик
басня: басен
фестиваль: фестивале
хабаровск: хабаровске
могила: могила
хаим: хаиму
унт: унта
малопопулярный: малопопулярен
вышэйший: вышэйшая
спутник: спутником
левша: левша
фев: фев
плазменный: плазменно
странствование: странствований
иммунохимический: иммунохимическая
геокарта: геокарт
гарем: гарема
музыкальный: музыкальную
потеря: потерь
инвентаризация: инвентаризация
расформировать: расформирован
робертсон: робертсон
социолог: социолог
фахир: фахир
таджуддин: таджуддин
итеративный: итеративно
дендрология: дендрология
вынудить: вынужден
соболев: соболев
кинопроцесс: кинопроцессе
обновить: обновить
оклад: окладом
ке: ке
тейлор: тейлора
пускать: пускали
франковский: франковская
функционирование: функционирования
климат: климатов
авраам: авраам
паника: паники
дыра: дыра
арестовываться: арестовывался
алеса: алеса
даваться: даются
ярославль: ярославле
мушегович: мушегович
осмий: осмия
канал: канала
футуролог: футурологи
шоломович: шоломович
передаваться: передается
откуда: откуда
добро: добру
нбв: нбв
произнести: произнесенная
бэйкер: бэйкер
модификация: модификаций
авагерец: авагерец
долгожитель: долгожители
милан: милане
макеев: макеев
сообщение: сообщении
каскад: каскаде
пользование: пользования
погибнуть: погиб
научий: науч
добрый: добрая
практически: практически
жизнь: жизнью
юды: юды
нурланович: нурланович
абрашина: абрашин
кучковый: кучково
мордухович: мордухович
поэтика: поэтика
заочный: заочную
подмножество: подмножествах
комбриг: комбриг
редакционный: редакционно
флорист: флорист
